Year,State,Net Job Creation Rate,Births,DHS Denominator,Deaths,Entered,Entered Rate,Establishment Exit,Exited,Exited Rate,Firm Exits.Count,Job Creation.Continuers,Job Creation.Count,Job Creation.Rate,Job Destruction,Job Destruction.Continuers,Job Destruction.Count,Job Destruction.Rate,Net Job Creation,Number of Firms,Physical Locations,Rate/Births,Rate/Deaths,Reallocation Rate
1977,Alabama,5,89869,933909,58891,10634,17.2,5641,8057,13.1,5623,101653,191522,20.5,36602,85855,144746,15.5,46776,52371,62852,9.6,6.3,31
1977,Alaska,-1.8,19259,108134,13504,2028,27,1039,1564,20.8,1035,18286,37545,34.7,6757,25981,39485,36.5,-1940,6480,7725,17.8,12.5,69.4
1977,Arizona,5.1,70645,589552,45366,9379,22,4357,6230,14.6,4332,76781,147426,25,29116,72063,117429,19.9,29997,36477,44113,12,7.7,39.8
1977,Arkansas,8.1,44527,529709,32531,7291,18.3,3994,5455,13.7,3970,75201,119728,22.6,19678,44394,76925,14.5,42803,35499,40702,8.4,6.1,29
1977,California,10.1,779164,6484959,488562,88187,20.7,39932,60589,14.2,39693,960214,1739378,26.8,276475,594123,1082685,16.7,656693,362887,438766,12,7.5,33.4
1977,Colorado,7,93270,786550,62313,12874,22.2,5694,8248,14.2,5673,104973,198243,25.2,37131,80745,143058,18.2,55185,51642,60187,11.9,7.9,36.4
1977,Connecticut,8.3,69857,1059999,47273,9153,15.2,4263,6634,11,4248,144993,214850,20.3,24208,79955,127228,12,87622,53879,61410,6.6,4.5,24
1977,Delaware,2.1,14260,220859,9058,1954,17.6,810,1250,11.2,807,20557,34817,15.8,5417,21206,30264,13.7,4553,9919,11465,6.5,4.1,27.4
1977,District of Columbia,0.6,27830,296031,20610,2262,15.2,1135,1855,12.5,1131,31594,59424,20.1,9899,37119,57729,19.5,1695,13027,15041,9.4,7,39
1977,Florida,8.8,319998,2316656,191982,36816,20.7,19236,27045,15.2,19132,302876,622874,26.9,120706,226401,418383,18.1,204491,151970,182091,13.8,8.3,36.2
1977,Geogia,5.5,146754,1452463,97339,17573,18.7,8911,13166,14,8877,173172,319926,22,56643,141751,239090,16.5,80836,78451,95914,10.1,6.7,33
1977,Hawaii,6.1,27592,253382,19811,3306,19,1438,2150,12.4,1422,27993,55585,21.9,10556,20323,40134,15.8,15451,14785,17914,10.9,7.8,31.6
1977,Idaho,23.9,24359,231419,15378,3729,20.5,1749,2500,13.7,1738,67757,92116,39.8,9788,21331,36709,15.9,55407,16105,18790,10.5,6.6,31.8
1977,Illinois,5.7,293000,3811704,202049,30780,15.2,16871,25527,12.6,16751,452823,745823,19.6,107141,328929,530978,13.9,214845,175560,204938,7.7,5.3,27.8
1977,Indiana,4.7,122035,1669441,81202,14426,15.4,7499,11454,12.2,7438,176792,298827,17.9,50182,139505,220707,13.2,78120,79024,95182,7.3,4.9,26.4
1977,Iowa,7.1,68130,809119,50775,10154,16.1,5295,7961,12.6,5274,100982,169112,20.9,31820,61101,111876,13.8,57236,54755,64042,8.4,6.3,27.6
1977,Kansas,8.6,86853,655567,44771,8534,16.7,4729,6944,13.6,4706,73081,159934,24.4,26825,58613,103384,15.8,56550,44466,51782,13.2,6.8,31.6
1977,Kentucky,7.1,73635,885353,52001,9711,16.8,5226,7697,13.3,5214,119856,193491,21.9,31052,78707,130708,14.8,62783,50186,58576,8.3,5.9,29.6
1977,Louisiana,6,96403,992319,61750,11802,17.3,5852,8216,12,5819,126917,223320,22.5,37703,102161,163911,16.5,59409,58952,70029,9.7,6.2,33
1977,Maine,6.1,27020,283875,16956,3441,16.2,1762,2749,12.9,1756,32860,59880,21.1,9457,25579,42535,15,17345,18929,21673,9.5,6,30
1977,Maryland,2.5,87380,1112672,65776,11007,16.4,5223,8105,12,5202,135360,222740,20,33840,129470,195246,17.5,27494,57557,68669,7.9,5.9,35
1977,Massachusetts,7.3,156633,1881581,104349,14690,13.7,7849,12039,11.2,7820,232821,389454,20.7,55353,147392,251741,13.4,137713,93706,108715,8.3,5.5,26.8
1977,Michigan,7.4,198770,2620761,129324,23171,16,11516,18173,12.6,11444,333924,532694,20.3,71034,208472,337796,12.9,194898,122826,147031,7.6,4.9,25.8
1977,Minnesota,8.4,108577,1230894,73208,12235,16.2,5833,8977,11.9,5779,173802,282379,22.9,43594,105537,178745,14.5,103634,65489,76960,8.8,5.9,29
1977,Mississippi,7.4,48125,560084,34706,6881,17.2,3754,5252,13.1,3728,74685,122810,21.9,22449,46325,81031,14.5,41779,34771,40703,8.6,6.2,29
1977,Missouri,5.4,113532,1469236,89617,15093,16.1,8321,12456,13.3,8281,183319,296851,20.2,47534,127491,217108,14.8,79743,79865,94772,7.7,6.1,29.6
1977,Montana,13.9,23009,178501,13323,3670,20,1675,2397,13.1,1670,30799,53808,30.1,9899,15544,28867,16.2,24941,16633,18922,12.9,7.5,32.4
1977,Nebraska,9.7,38510,451602,29267,5742,16.2,2982,4374,12.3,2971,77529,116039,25.7,19346,43038,72305,16,43734,31391,36091,8.5,6.5,32
1977,Nevada,9.9,24771,224173,15357,3258,23.1,1469,2044,14.5,1465,32400,57171,25.5,9485,19576,34933,15.6,22238,12872,14682,11,6.9,31.2
1977,New Hampshire,6.6,20146,253772,14599,3204,17.9,1407,2063,11.5,1400,31051,51197,20.2,8623,19898,34497,13.6,16700,16553,18449,7.9,5.8,27.2
1977,New Jersey,3.7,178309,2258998,131558,20677,14.8,11057,17341,12.4,11014,249792,428101,19,63980,215066,346624,15.3,81477,124638,141637,7.9,5.8,30.6
1977,New Mexico,5.9,33274,266415,22137,4889,20.8,2429,3459,14.7,2421,33829,67103,25.2,13603,29360,51497,19.3,15606,20904,24176,12.5,8.3,38.6
1977,New York,3.7,402075,5434966,323854,48067,13.7,31402,44902,12.8,31294,642565,1044640,19.2,181801,517757,841611,15.5,203029,312227,353279,7.4,6,31
1977,North Carolina,3.6,132489,1719698,88097,16734,16.7,8412,12387,12.3,8384,174100,306589,17.8,51648,155901,243998,14.2,62591,84511,102521,7.7,5.1,28.4
1977,North Dakota,3.5,14237,146646,10832,2435,16.6,1175,1871,12.8,1170,15316,29553,20.2,7566,13588,24420,16.7,5133,13177,14917,9.7,7.4,33.4
1977,Ohio,6.2,255150,3436627,171098,27571,14.8,13812,21859,11.7,13726,406990,662140,19.3,90134,280524,451622,13.1,210518,152029,189077,7.4,5,26.2
1977,Oklahoma,6.9,78333,721654,50346,10526,18.4,5652,7817,13.7,5626,86690,165023,22.9,32495,64986,115332,16,49691,50336,58471,10.9,7,32
1977,Oregon,7.1,71803,672087,50465,10970,20.9,4997,7492,14.3,4972,83830,155633,23.2,30325,57800,108265,16.1,47368,46565,54000,10.7,7.5,32.2
1977,Pennsylvania,5.4,274187,3747564,183802,28483,13.8,14526,22690,11,14433,435878,710065,18.9,94367,320780,504582,13.5,205483,174493,208707,7.3,4.9,27
1977,Rhode Island,20.7,18286,324421,14848,2770,14.4,1462,2227,11.6,1452,88028,106314,32.8,7106,24246,39094,12.1,67220,17573,19459,5.6,4.6,24.2
1977,South Carolina,2.7,59698,827937,41938,8438,17.2,4229,6094,12.4,4204,77247,136945,16.5,23887,71989,113927,13.8,23018,42348,50173,7.2,5.1,27.6
1977,South Dakota,27.1,25862,171956,10499,2501,16.2,1255,2013,13.1,1255,45923,71785,41.7,6637,14577,25076,14.6,46709,13882,15605,15,6.1,29.2
1977,Tennessee,6.2,121560,1273560,74336,13760,17.9,6971,10117,13.2,6941,146050,267610,21,44016,114150,188486,14.8,79124,65615,78338,9.5,5.8,29.6
1977,Texas,7.5,434064,3845503,264045,49803,19.4,23750,34101,13.3,23575,506539,940603,24.5,157804,387859,651904,17,288699,214505,263754,11.3,6.9,34
1977,Utah,9.8,38733,339655,26057,5073,21.4,2167,3305,14,2147,53961,92694,27.3,15813,33276,59333,17.5,33361,21269,24554,11.4,7.7,35
1977,Vermont,8.7,13726,139006,8799,1914,16.9,912,1347,11.9,909,17583,31309,22.5,4669,10387,19186,13.8,12123,10485,11609,9.9,6.3,27.6
1977,Virginia,4.5,127378,1360683,79434,14413,16.7,7027,10720,12.4,6985,155515,282893,20.8,42951,141854,221288,16.3,61605,72552,88154,9.4,5.8,32.6
1977,Washington,9.2,112311,982351,65408,15570,20.7,6595,10117,13.4,6565,130401,242712,24.7,39509,86413,151821,15.5,90891,66226,77856,11.4,6.7,31
1977,West Virginia,5.5,41437,459237,31646,4779,15.7,2478,3800,12.5,2463,57153,98590,21.5,13568,41655,73301,16,25289,26551,30888,9,6.9,32
1977,Wisconsin,4.8,96695,1401243,69944,13131,15.3,6269,9807,11.4,6219,142053,238748,17,38462,100721,170665,12.2,68083,75854,87660,6.9,5,24.4
1977,Wyoming,12.3,15382,102991,8866,2260,21.9,928,1373,13.3,926,16116,31498,30.6,6309,10020,18886,18.3,12612,9659,10761,14.9,8.6,36.6
1978,Alabama,7.5,72111,994708,55224,10260,16,5688,8002,12.5,5667,140955,213066,21.4,30942,82860,138084,13.9,74982,54168,65096,7.2,5.6,27.8
1978,Alaska,3,13069,108602,15082,1799,22.9,842,1484,18.9,837,22935,36004,33.2,6987,17715,32797,30.2,3207,6761,8010,12,13.9,60.4
1978,Arizona,8.9,60241,630226,56864,7743,17.8,4931,8348,19.2,4885,102764,163005,25.9,28307,50500,107364,17,55641,35147,43021,9.6,9,34
1978,Arkansas,2.6,36140,556487,47659,5932,14.9,4434,7208,18.1,4419,71490,107630,19.3,21675,45551,93210,16.7,14420,33699,38928,6.5,8.6,33.4
1978,California,6.3,596335,7022464,528511,81007,18.2,41725,66905,15,41450,1085642,1681977,24,247948,714287,1242798,17.7,439179,375003,452620,8.5,7.5,35.4
1978,Colorado,7.8,73365,843859,74935,10793,18.1,6740,11113,18.6,6706,139709,213074,25.2,38425,71853,146788,17.4,66286,50226,59213,8.7,8.9,34.8
1978,Connecticut,3.2,52710,1121703,63706,8081,13,4308,6271,10.1,4291,140181,192891,17.2,32288,93069,156775,14,36116,55495,63208,4.7,5.7,28
1978,Delaware,-0.1,9385,223021,40838,1455,12.8,1232,1633,14.4,1231,49585,58970,26.4,34224,18267,59105,26.5,-135,9701,11289,4.2,18.3,52.8
1978,District of Columbia,6.7,16796,307089,16725,1950,12.9,1138,1755,11.6,1122,45743,62539,20.4,8149,25337,42062,13.7,20477,13227,15244,5.5,5.4,27.4
1978,Florida,5.9,241170,2491389,190812,35042,18.8,18967,26327,14.1,18883,379140,620310,24.9,110612,283435,474247,19,146063,159721,190761,9.7,7.7,38
1978,Geogia,7.9,116387,1554502,93045,15577,16,8746,12529,12.9,8709,224365,340752,21.9,52218,124912,217957,14,122795,81041,98922,7.5,6,28
1978,Hawaii,5.3,21978,268253,20138,2833,15.5,1419,2190,12,1405,34204,56182,20.9,7582,21735,41873,15.6,14309,15388,18557,8.2,7.5,31.2
1978,Idaho,-11.5,21739,243944,20769,3062,16.5,1921,3288,17.7,1912,33434,55173,22.6,9996,62509,83278,34.1,-28105,15632,18330,8.9,8.5,45.2
1978,Illinois,4,219052,3997676,201422,27486,13.3,16528,23997,11.6,16387,492788,711840,17.8,98513,351351,552773,13.8,159067,178543,208502,5.5,5,27.6
1978,Indiana,6.9,90438,1768937,77489,13090,13.6,7361,10729,11.1,7320,237901,328339,18.6,40910,129139,206628,11.7,121711,81021,97478,5.1,4.4,23.4
1978,Iowa,4.6,54955,856849,41676,8988,13.9,5364,7426,11.5,5339,103997,158952,18.6,25468,78469,120145,14,38807,56025,65568,6.4,4.9,28
1978,Kansas,2.7,51261,691984,41566,7850,14.9,4430,6264,11.9,4417,88886,140147,20.3,23865,80166,121732,17.6,18415,45724,53325,7.4,6,35.2
1978,Kentucky,4.3,60162,936461,60125,9082,15.3,5245,7408,12.5,5233,123672,183834,19.6,25056,83620,143745,15.3,40089,51398,60188,6.4,6.4,30.6
1978,Louisiana,8.6,74763,1062924,73187,9461,13.7,6371,10691,15.5,6345,178847,253610,23.9,36249,89276,162463,15.3,91147,56705,68048,7,6.9,30.6
1978,Maine,8.2,19027,297080,14471,3418,15.5,1812,2533,11.5,1807,43078,62105,20.9,8329,23223,37694,12.7,24411,19655,22500,6.4,4.9,25.4
1978,Maryland,4.3,69148,1150318,62982,9599,13.8,5244,7874,11.3,5222,152175,221323,19.2,29272,108961,171943,14.9,49380,59019,70407,6,5.5,29.8
1978,Massachusetts,7.2,114895,2022855,110877,13209,12.1,7672,11451,10.4,7618,283687,398582,19.7,48507,142101,252978,12.5,145604,95418,110492,5.7,5.5,25
1978,Michigan,6.7,166774,2793463,138606,21107,14.2,11637,17433,11.7,11581,353036,519810,18.6,69164,195037,333643,11.9,186167,125933,150639,6,5,23.8
1978,Minnesota,6.8,83671,1327630,67708,11114,14.2,5900,8496,10.9,5870,201749,285420,21.5,34237,127607,195315,14.7,90105,67767,79558,6.3,5.1,29.4
1978,Mississippi,4.5,42856,594424,33980,6185,15.1,3811,5694,13.9,3800,77178,120034,20.2,17983,59294,93274,15.7,26760,35073,41205,7.2,5.7,31.4
1978,Missouri,5.4,99056,1550852,93361,14054,14.7,8297,12019,12.6,8268,211143,310199,20,40896,132939,226300,14.6,83899,81346,96711,6.4,6,29.2
1978,Montana,3.6,16139,193375,19624,2890,15.5,1920,3267,17.5,1916,30577,46716,24.2,9760,20164,39788,20.6,6928,15956,18322,8.3,10.1,41.2
1978,Nebraska,1.7,30239,477295,33233,5004,13.7,2975,4157,11.4,2951,68111,98350,20.6,15148,56976,90209,18.9,8141,32033,36894,6.3,7,37.8
1978,Nevada,13.7,25063,251213,23286,2841,19.5,1637,2875,19.7,1633,47739,72802,29,11388,15207,38493,15.3,34309,12572,14468,10,9.3,30.6
1978,New Hampshire,12,25241,278607,13161,3132,16.5,1534,2141,11.3,1528,40197,65438,23.5,7214,18843,32004,11.5,33434,17428,19426,9.1,4.7,23
1978,New Jersey,4.6,137481,2348078,139931,19059,13.3,10816,16284,11.4,10775,307642,445123,19,58403,198386,338317,14.4,106806,127081,144463,5.9,6,28.8
1978,New Mexico,7.4,25533,282983,29780,3820,16.1,2719,4419,18.6,2715,48035,73568,26,17516,22834,52614,18.6,20954,19821,23243,9,10.5,37.2
1978,New York,3.7,315152,5662022,353722,43751,12.4,30932,43379,12.3,30832,787689,1102841,19.5,172072,538174,891896,15.8,210945,313062,353760,5.6,6.2,31.6
1978,North Carolina,6.1,108021,1799943,91530,15728,15.1,8562,12132,11.6,8526,217277,325298,18.1,43857,125137,216667,12,108631,87640,106079,6,5.1,24
1978,North Dakota,8.9,11304,156069,8124,2203,14.5,1193,1709,11.3,1189,22060,33364,21.4,5327,11377,19501,12.5,13863,13603,15383,7.2,5.2,25
1978,Ohio,3.6,178168,3603082,163584,24430,12.8,13667,20672,10.8,13610,437396,615564,17.1,71255,321837,485421,13.5,130143,154897,192855,4.9,4.5,27
1978,Oklahoma,4.2,59579,759417,71350,8755,15.3,6360,10543,18.4,6344,103541,163120,21.5,36622,59711,131061,17.3,32059,47600,55988,7.8,9.4,34.6
1978,Oregon,14,69772,747631,52049,10748,19.4,5301,7828,14.1,5283,135725,205497,27.5,27853,48821,100870,13.5,104627,49114,56878,9.3,7,27
1978,Pennsylvania,2,198829,3879649,235586,25306,12,14859,22355,10.6,14774,495614,694443,17.9,119050,380318,615904,15.9,78539,176944,211614,5.1,6.1,31.8
1978,Rhode Island,-7,20710,345722,18484,2499,12.7,1440,2088,10.6,1438,46932,67642,19.6,7988,73430,91914,26.6,-24272,17892,19843,6,5.3,39.2
1978,South Carolina,8.5,64901,875944,39626,8030,15.7,4403,6095,11.9,4392,108073,172974,19.7,18593,58398,98024,11.2,74950,43868,52112,7.4,4.5,22.4
1978,South Dakota,-13,12789,182954,9076,2415,15.2,1306,1864,11.7,1305,24533,37322,20.4,5665,52051,61127,33.4,-23805,14365,16130,7,5,40.8
1978,Tennessee,5.3,87492,1350566,78670,12067,15.2,6972,9967,12.6,6950,184052,271544,20.1,38450,120794,199464,14.8,72080,67459,80407,6.5,5.8,29.6
1978,Texas,5.9,326654,4089419,357495,40567,15.7,26702,46430,17.9,26558,630540,957194,23.4,174431,359133,716628,17.5,240566,204020,254416,8,8.7,35
1978,Utah,6.1,31944,365349,31018,4125,17,2410,4355,17.9,2401,53514,85458,23.4,14870,32015,63033,17.3,22425,20623,24015,8.7,8.5,34.6
1978,Vermont,8.5,13881,151138,12244,1913,16.1,968,1288,10.8,961,22044,35925,23.8,4973,10856,23100,15.3,12825,11078,12226,9.2,8.1,30.6
1978,Virginia,6,93808,1433692,82262,13626,15.2,6907,10060,11.2,6880,192125,285933,19.9,42339,117538,199800,13.9,86133,75541,91681,6.5,5.7,27.8
1978,Washington,15.5,104323,1113157,73594,15023,18.8,7057,11137,14,7033,225041,329364,29.6,40738,83313,156907,14.1,172457,69558,81677,9.4,6.6,28.2
1978,West Virginia,-3.8,23609,462161,24020,4177,13.4,2484,3756,12.1,2478,48979,72588,15.7,11280,66095,90115,19.5,-17527,26917,31297,5.1,5.2,31.4
1978,Wisconsin,7.5,83921,1489387,67604,12536,14,6389,9124,10.2,6361,187243,271164,18.2,34761,91230,158834,10.7,112330,78852,91036,5.6,4.5,21.4
1978,Wyoming,13.4,13906,116514,12265,1984,18.5,1180,1971,18.4,1178,23294,37200,31.9,6059,9251,21516,18.5,15684,9470,10634,11.9,10.5,37
1979,Alabama,5.2,75192,1055982,64732,9436,14.4,5914,8106,12.4,5899,144164,219356,20.8,35731,100363,165095,15.6,54261,54730,65955,7.1,6.1,31.2
1979,Alaska,-1.7,11685,108822,12091,1804,22.1,907,1400,17.2,904,17229,28914,26.6,5560,18707,30798,28.3,-1884,7058,8298,10.7,11.1,53.2
1979,Arizona,15.2,75771,714182,31143,9229,20.1,132,3881,8.5,118,126007,201778,28.3,1452,62605,93748,13.1,108030,40325,48734,10.6,4.4,26.2
1979,Arkansas,6.5,43304,583549,22603,6430,15.9,73,3658,9,66,70351,113655,19.5,2171,53062,75665,13,37990,36633,41977,7.4,3.9,26
1979,California,9,720477,7568239,475544,89981,19.3,42089,60626,13,41901,1136004,1856481,24.5,257452,699842,1175386,15.5,681095,397902,478672,9.5,6.3,31
1979,Colorado,11.5,89746,932493,47808,12087,19.4,123,6051,9.7,106,145092,234838,25.2,3424,80305,128113,13.7,106725,56438,65644,9.6,5.1,27.4
1979,Connecticut,6.1,62534,1174374,45613,7968,12.4,4167,6031,9.4,4160,136979,199513,17,21983,82334,127947,10.9,71566,56971,64839,5.3,3.9,21.8
1979,Delaware,-8.5,11430,213347,8172,1545,13.5,820,1203,10.5,809,19900,31330,14.7,3978,41317,49489,23.2,-18159,9922,11562,5.4,3.8,29.4
1979,District of Columbia,8.1,14835,330425,15052,1872,12.2,1054,1607,10.5,1053,49643,64478,19.5,6545,22458,37510,11.4,26968,13368,15419,4.5,4.6,22.8
1979,Florida,8.4,265284,2671506,182847,35973,18.4,18822,25357,13,18717,392538,657822,24.6,114510,249575,432422,16.2,225400,167423,200091,9.9,6.8,32.4
1979,Geogia,4.9,125154,1656238,89695,15322,15.3,8797,12250,12.2,8777,202777,327931,19.8,46769,156278,245973,14.9,81958,82563,101415,7.6,5.4,29.8
1979,Hawaii,8.2,24331,287811,15616,3148,16.5,1407,2052,10.8,1398,39866,64197,22.3,8575,25097,40713,14.1,23484,16172,19545,8.5,5.4,28.2
1979,Idaho,16.2,48351,252502,11796,3259,17,34,1729,9,33,30394,78745,31.2,369,25955,37751,15,40994,17198,20007,19.1,4.7,30
1979,Illinois,4.4,235057,4163606,212717,26460,12.6,16242,23364,11.2,16189,515122,750179,18,99206,352399,565116,13.6,185063,179478,210329,5.6,5.1,27.2
1979,Indiana,3.4,94981,1858703,79536,12611,12.8,7599,10611,10.8,7566,211700,306681,16.5,41438,163990,243526,13.1,63155,81904,98946,5.1,4.3,26.2
1979,Iowa,4.8,52737,896269,45603,7941,12.1,5546,7600,11.6,5485,106113,158850,17.7,26839,70415,116018,12.9,42832,55826,65548,5.9,5.1,25.8
1979,Kansas,6.4,46496,722802,39881,7218,13.4,4460,6219,11.6,4448,98673,145169,20.1,22021,59225,99106,13.7,46063,46263,54040,6.4,5.5,27.4
1979,Kentucky,5.7,67028,982930,51855,8596,14.1,5164,7006,11.5,5151,129226,196254,20,29037,88712,140567,14.3,55687,52229,61390,6.8,5.3,28.6
1979,Louisiana,8.7,89541,1165412,50712,11200,15.7,76,5514,7.8,57,171281,260822,22.4,1700,109185,159897,13.7,100925,62363,74231,7.7,4.4,27.4
1979,Maine,2.5,19386,312846,15106,3054,13.5,1850,2590,11.4,1844,34199,53585,17.1,8580,30445,45551,14.6,8034,19874,22803,6.2,4.8,29.2
1979,Maryland,4.6,73270,1201420,65363,9756,13.7,5480,7883,11.1,5445,149293,222563,18.5,29949,101360,166723,13.9,55840,60029,71902,6.1,5.4,27.8
1979,Massachusetts,5.2,115994,2149249,88442,13252,11.9,7533,10914,9.8,7506,270818,386812,18,45723,186973,275415,12.8,111397,96906,112318,5.4,4.1,25.6
1979,Michigan,5.3,160823,2985065,126469,20204,13.3,11570,16678,11,11511,348988,509811,17.1,69149,226188,352657,11.8,157154,127979,153321,5.4,4.2,23.6
1979,Minnesota,7.1,92124,1422387,66064,10829,13.4,5940,8499,10.6,5920,191843,283967,20,33403,117867,183931,12.9,100036,69373,81497,6.5,4.6,25.8
1979,Mississippi,6.2,45033,626893,34492,6614,15.8,3745,4992,11.9,3734,85413,130446,20.8,19545,56995,91487,14.6,38959,36186,42542,7.2,5.5,29.2
1979,Missouri,5.7,94849,1635903,81578,13335,13.7,8040,11340,11.6,7979,211182,306031,18.7,43086,131858,213436,13,92595,82490,98170,5.8,5,26
1979,Montana,14.4,19182,212784,8756,3324,17.3,20,1689,8.8,20,39029,58211,27.4,221,18893,27649,13,30562,17673,20098,9,4.1,26
1979,Nebraska,4.2,28082,490865,22789,4608,12.4,2802,4047,10.9,2796,64894,92976,18.9,12552,49513,72302,14.7,20674,32331,37234,5.7,4.6,29.4
1979,Nevada,17.7,37943,295553,13059,3551,22.7,91,1366,8.7,90,52259,90202,30.5,842,24723,37782,12.8,52420,14667,16788,12.8,4.4,25.6
1979,New Hampshire,8.3,19477,307687,14011,2936,14.9,1583,2196,11.1,1577,43978,63455,20.6,7407,23817,37828,12.3,25627,17921,20047,6.3,4.6,24.6
1979,New Jersey,4.4,150545,2452369,121555,19551,13.4,10322,15093,10.3,10295,298839,449384,18.3,56858,220483,342038,13.9,107346,130213,148059,6.1,5,27.8
1979,New Mexico,10.6,31773,311227,16743,4471,18.3,41,2309,9.5,36,46619,78392,25.2,832,28600,45343,14.6,33049,22016,25590,10.2,5.4,29.2
1979,New York,2.4,316196,5829407,308833,43039,12.1,29064,39583,11.2,28950,701771,1017967,17.5,162524,570261,879094,15.1,138873,314425,355506,5.4,5.3,30.2
1979,North Carolina,6.1,114582,1910551,85993,15066,14,8634,11909,11.1,8614,224295,338877,17.7,44753,135984,221977,11.6,116900,89357,108599,6,4.5,23.2
1979,North Dakota,8.9,14478,170166,9423,2263,14.5,1247,1731,11.1,1246,24693,39171,23,6591,14554,23977,14.1,15194,13973,15791,8.5,5.5,28.2
1979,Ohio,4.7,198112,3750740,168034,23967,12.3,13400,20219,10.4,13348,426534,624646,16.7,74907,282961,450995,12,173651,156872,195658,5.3,4.5,24
1979,Oklahoma,10.8,71145,821971,36967,9984,17,98,4991,8.5,91,125153,196298,23.9,1235,70379,107346,13.1,88952,52568,61399,8.7,4.5,26.2
1979,Oregon,8.9,72124,834609,52923,10747,18.5,5688,7874,13.6,5680,140890,213014,25.5,30102,85222,138145,16.6,74869,51134,59275,8.6,6.3,33.2
1979,Pennsylvania,2.3,188922,3960793,175270,24802,11.6,14461,21000,9.9,14390,449484,638406,16.1,78761,370324,545594,13.8,92812,178595,214372,4.8,4.4,27.6
1979,Rhode Island,2.7,18715,337806,14341,2451,12.2,1342,1917,9.6,1340,39480,58195,17.2,7370,34711,49052,14.5,9143,18273,20277,5.5,4.2,29
1979,South Carolina,5.2,51789,938815,38282,7374,14,4557,6155,11.7,4523,111783,163572,17.4,22195,76113,114395,12.2,49177,44350,53006,5.5,4.1,24.4
1979,South Dakota,8.4,14858,178064,9904,2257,13.9,1328,1868,11.5,1327,24609,39467,22.2,6139,14673,24577,13.8,14890,14557,16417,8.3,5.6,27.6
1979,Tennessee,5.1,96506,1421203,72814,11986,14.8,7199,10104,12.5,7187,178058,274564,19.3,38245,128412,201226,14.2,73338,68306,81771,6.8,5.1,28.4
1979,Texas,10.1,419040,4451203,199521,47590,17.7,381,22228,8.3,308,671394,1090434,24.5,9442,439461,638982,14.4,451452,228595,282055,9.4,4.5,28.8
1979,Utah,8.9,36997,395122,17691,4560,18,41,2025,8,37,54790,91787,23.2,650,38782,56473,14.3,35314,23101,26722,9.4,4.5,28.6
1979,Vermont,4.3,10357,160819,8177,1753,14.1,1046,1360,11,1040,19877,30234,18.8,5397,15077,23254,14.5,6980,11344,12557,6.4,5.1,29
1979,Virginia,5,99825,1512843,73657,13106,14.1,7422,10377,11.2,7399,187755,287580,19,37383,137497,211154,14,76426,77100,93949,6.6,4.9,28
1979,Washington,1.8,105212,1207327,98847,15324,18.3,7512,10892,13,7480,182586,287798,23.8,40436,167217,266064,22,21734,72969,85408,8.7,8.2,44
1979,West Virginia,15.3,28775,489740,20845,4349,13.8,2536,3581,11.3,2529,103521,132296,27,10888,36534,57379,11.7,74917,27284,31823,5.9,4.3,23.4
1979,Wisconsin,4.8,82724,1583678,63667,11376,12.4,6463,9199,10,6444,177195,259919,16.4,33301,119411,183078,11.6,76841,80177,92794,5.2,4,23.2
1979,Wyoming,11.1,15479,132024,6545,2227,19.7,26,1015,9,25,20374,35853,27.2,272,14736,21281,16.1,14572,10651,11919,11.7,5,32.2
1980,Alabama,-0.1,61121,1080875,58053,8630,13.1,6086,8426,12.8,6072,118247,179368,16.6,33755,121929,179982,16.7,-614,54494,65852,5.7,5.4,33.2
1980,Alaska,0.8,8883,107880,7888,1477,17.8,892,1346,16.2,886,15370,24253,22.5,4606,15486,23374,21.7,879,7082,8324,8.2,7.3,43.4
1980,Arizona,4.6,72404,784645,48731,9389,18.8,4775,6662,13.3,4763,100541,172945,22,28763,88143,136874,17.4,36071,42362,51152,9.2,6.2,34.8
1980,Arkansas,3,36084,610998,31904,5628,13.4,3981,5457,13,3971,76352,112436,18.4,17746,62413,94317,15.4,18119,36610,41952,5.9,5.2,30.8
1980,California,4.3,662641,8070425,509990,81844,16.8,44573,63887,13.1,44372,1061473,1724114,21.4,281515,869257,1379247,17.1,344867,411314,494149,8.2,6.3,34.2
1980,Colorado,3.9,85392,1001872,72878,11825,17.7,6606,9311,14,6583,126037,211429,21.1,42218,99731,172609,17.2,38820,58297,67728,8.5,7.3,34.4
1980,Connecticut,3.6,60611,1230114,47871,7590,11.6,4595,6535,10,4554,132484,193095,15.7,23569,100527,148398,12.1,44697,57616,65666,4.9,3.9,24.2
1980,Delaware,3.3,11142,207446,9206,1342,11.6,912,1316,11.4,887,20340,31482,15.2,4646,15446,24652,11.9,6830,9956,11551,5.4,4.4,23.8
1980,District of Columbia,3.6,16839,349621,30166,1882,12.1,1099,1682,10.8,1095,59652,76491,21.9,7388,33780,63946,18.3,12545,13573,15600,4.8,8.6,36.6
1980,Florida,6.4,281115,2876941,187917,36311,17.7,19564,26348,12.9,19499,373603,654718,22.8,116237,284735,472652,16.4,182066,175454,209305,9.8,6.5,32.8
1980,Geogia,2.4,112458,1717525,94093,14144,13.9,8872,12510,12.3,8830,192161,304619,17.7,47751,169316,263409,15.3,41210,83538,102668,6.5,5.5,30.6
1980,Hawaii,1.8,23490,301581,17011,3142,15.7,1474,2176,10.9,1460,31079,54569,18.1,9700,32141,49152,16.3,5417,16929,20433,7.8,5.6,32.6
1980,Idaho,-9.5,18415,260249,17393,3033,15.1,1967,2750,13.7,1959,30177,48592,18.7,9969,55959,73352,28.2,-24760,17306,20154,7.1,6.7,37.4
1980,Illinois,-1.6,214790,4218402,198851,24930,11.8,16526,23577,11.2,16441,370801,585591,13.9,94857,455441,654292,15.5,-68701,179908,211082,5.1,4.7,27.8
1980,Indiana,-2.9,93016,1861237,81446,11525,11.6,7676,10941,11,7641,158466,251482,13.5,39265,222909,304355,16.4,-52873,81874,99140,5,4.4,27
1980,Iowa,-0.5,49251,913100,48068,7611,11.6,5327,7178,10.9,5314,85855,135106,14.8,28356,91916,139984,15.3,-4878,55749,65666,5.4,5.3,29.6
1980,Kansas,1.3,44071,749703,35525,6597,12.2,4543,6339,11.7,4532,79400,123471,16.5,22525,78121,113646,15.2,9825,46254,54081,5.9,4.7,30.4
1980,Kentucky,-0.5,54795,1007266,47030,7362,12,5372,7329,12,5356,101447,156242,15.5,27403,113943,160973,16,-4731,51793,61174,5.4,4.7,31
1980,Louisiana,2.8,84660,1231262,67600,10607,14.1,6352,8772,11.7,6320,159466,244126,19.8,39622,142238,209838,17,34288,63552,75731,6.9,5.5,34
1980,Maine,0.8,16786,317362,16741,2758,12.1,1858,2668,11.7,1847,33210,49996,15.8,8536,30755,47496,15,2500,19757,22728,5.3,5.3,30
1980,Maryland,5.2,102859,1264884,60600,9143,12.6,5452,8028,11.1,5417,149099,251958,19.9,31888,125727,186327,14.7,65631,60838,72838,8.1,4.8,29.4
1980,Massachusetts,3.2,108281,2239912,100621,12445,11,7569,11065,9.8,7517,265300,373581,16.7,48711,201806,302427,13.5,71154,97762,113338,4.8,4.5,27
1980,Michigan,-5.8,145181,2970906,141696,18598,12.1,12059,17456,11.4,12019,230487,375668,12.6,67307,406278,547974,18.4,-172306,127753,153767,4.9,4.8,25.2
1980,Minnesota,1.8,83514,1484861,72388,9964,12.1,5982,8543,10.4,5943,160369,243883,16.4,39022,144696,217084,14.6,26799,70287,82646,5.6,4.9,29.2
1980,Mississippi,-0.2,39621,645528,34540,5817,13.6,3796,5158,12.1,3773,65167,104788,16.2,19808,71603,106143,16.4,-1355,36518,43031,6.1,5.4,32.4
1980,Missouri,-0.4,89912,1676529,84183,11971,12.2,8175,11547,11.8,8152,164443,254355,15.2,41837,177757,261940,15.6,-7585,82350,98116,5.4,5,30.4
1980,Montana,-4.1,16849,223406,14751,2891,14.4,1876,2704,13.4,1870,21449,38298,17.1,9335,32629,47380,21.2,-9082,17724,20141,7.5,6.6,34.2
1980,Nebraska,2.5,29239,506666,23285,4429,11.9,2984,4153,11.1,2975,56596,85835,16.9,14816,49632,72917,14.4,12918,32400,37353,5.8,4.6,28.8
1980,Nevada,5.8,32628,329669,22960,3431,19.9,1801,2477,14.4,1794,45896,78524,23.8,16658,36336,59296,18,19228,15355,17631,9.9,7,36
1980,New Hampshire,2.4,18195,323960,17544,2553,12.7,1679,2334,11.6,1672,37087,55282,17.1,9597,30186,47730,14.7,7552,18005,20158,5.6,5.4,29.4
1980,New Jersey,1.6,136458,2524700,118888,18191,12.2,10914,15533,10.4,10873,274374,410832,16.3,57552,253443,372331,14.7,38501,132229,150343,5.4,4.7,29.4
1980,New Mexico,0.9,29326,328117,24492,4234,16.4,2529,3553,13.8,2525,38310,67636,20.6,14673,40273,64765,19.7,2871,22407,26027,8.9,7.5,39.4
1980,New York,1.7,314390,5918068,299762,40377,11.4,28890,39226,11,28818,653406,967796,16.4,158956,568567,868329,14.7,99467,314762,355779,5.3,5.1,29.4
1980,North Carolina,1.3,100393,1988483,86634,13844,12.7,8926,12449,11.4,8888,195073,295466,14.9,49223,184617,271251,13.6,24215,89884,109519,5,4.4,27.2
1980,North Dakota,3.3,13115,180081,9864,2058,13,1279,1796,11.3,1278,20329,33444,18.6,6586,17715,27579,15.3,5865,14077,15978,7.3,5.5,30.6
1980,Ohio,-1.5,180440,3806420,163195,21720,11.1,13828,20491,10.5,13738,340587,521027,13.7,75324,414903,578098,15.2,-57071,156831,196098,4.7,4.3,27.4
1980,Oklahoma,4.9,76640,885106,50024,9550,15.4,5909,7961,12.8,5882,112546,189186,21.4,30204,96008,146032,16.5,43154,53632,62673,8.7,5.7,33
1980,Oregon,-1.9,67872,862988,56721,9942,16.6,6140,8601,14.4,6109,95373,163245,18.9,33179,122511,179232,20.8,-15987,51986,60328,7.9,6.6,37.8
1980,Pennsylvania,0.5,193932,4022847,187118,22704,10.6,15277,22079,10.3,15214,385279,579211,14.4,86745,370928,558046,13.9,21165,178026,214132,4.8,4.7,27.8
1980,Rhode Island,-0.1,15267,340926,13739,2176,10.7,1459,2090,10.3,1458,32633,47900,14,7406,34467,48206,14.1,-306,18311,20297,4.5,4,28
1980,South Carolina,0.9,52465,966684,42782,7169,13.4,4523,6323,11.9,4506,91681,144146,14.9,21057,93018,135800,14,8346,44827,53627,5.4,4.4,28
1980,South Dakota,0.7,13029,186117,10454,2057,12.5,1368,1861,11.3,1364,18112,31141,16.7,6774,19283,29737,16,1404,14648,16540,7,5.6,32
1980,Tennessee,-1.4,85830,1445831,77243,11109,13.5,7251,10164,12.4,7236,139098,224928,15.6,39818,168614,245857,17,-20929,68649,82403,5.9,5.3,31.2
1980,Texas,1.7,273070,4604289,325610,28147,10.5,30581,41043,15.3,30408,626014,899084,19.5,192868,496080,821690,17.8,77394,197706,252919,5.9,7.1,35.6
1980,Utah,2.3,32823,416219,27385,4206,15.7,2693,3808,14.2,2678,48597,81420,19.6,15608,44565,71950,17.3,9470,23139,26904,7.9,6.6,34.6
1980,Vermont,3.2,9035,166906,7223,1652,13.1,1058,1397,11,1056,19898,28933,17.3,4549,16324,23547,14.1,5386,11514,12749,5.4,4.3,28.2
1980,Virginia,2.7,92235,1569964,70530,12450,13.2,7604,10822,11.4,7573,168273,260508,16.6,37651,148006,218536,13.9,41972,77942,95157,5.9,4.5,27.8
1980,Washington,3.5,94134,1237123,75094,13661,15.9,8126,11661,13.5,8098,164374,258508,20.9,43343,140517,215611,17.4,42897,73976,86798,7.6,6.1,34.8
1980,West Virginia,-7.9,26362,506848,24668,3750,11.8,2630,3669,11.5,2621,44796,71158,14,12632,86345,111013,21.9,-39855,27159,31783,5.2,4.9,28
1980,Wisconsin,-0.1,72931,1618761,66087,10351,11.1,6781,9544,10.3,6749,139045,211976,13.1,35373,147356,213443,13.2,-1467,80392,93227,4.5,4.1,26.2
1980,Wyoming,6.1,13664,143298,9642,2084,17.2,1175,1608,13.3,1172,20635,34299,23.9,6648,15833,25475,17.8,8824,10947,12300,9.5,6.7,35.6
1981,Alabama,-1.9,71309,1049506,77850,7972,12.4,6081,9381,14.6,6056,102501,173810,16.6,37042,116628,194478,18.5,-20668,52551,63502,6.8,7.4,33.2
1981,Alaska,9.1,11824,106881,8848,1480,17.9,750,1336,16.2,748,18584,30408,28.5,4444,11896,20744,19.4,9664,7104,8283,11.1,8.3,38.8
1981,Arizona,2.1,68460,797439,57838,8941,17.5,5257,8199,16,5241,95919,164379,20.6,30259,89514,147352,18.5,17027,42385,51310,8.6,7.3,37
1981,Arkansas,-2.4,44911,583058,37641,5424,13.3,4028,6144,15,4014,49793,94704,16.2,19401,70924,108565,18.6,-13861,35019,40278,7.7,6.5,32.4
1981,California,0.6,694330,8205240,665325,76971,15.7,45863,77407,15.8,45626,1003049,1697379,20.7,290518,986368,1651693,20.1,45686,408274,488896,8.5,8.1,40.2
1981,Colorado,3.1,100146,1017881,86744,11484,17.1,7037,11258,16.7,7006,133512,233658,23,45832,115902,202646,19.9,31012,57785,67245,9.8,8.5,39.8
1981,Connecticut,0.4,70315,1240396,67779,7366,11.4,4744,8268,12.8,4738,108764,179079,14.4,25687,105623,173402,14,5677,56444,64151,5.7,5.5,28
1981,Delaware,1.3,12208,211575,10737,1280,11.2,842,1488,13.1,839,19396,31604,14.9,4517,18108,28845,13.6,2759,9706,11249,5.8,5.1,27.2
1981,District of Columbia,-3.4,25259,354941,50677,1781,11.6,1189,2198,14.4,1184,43395,68654,19.3,12545,29923,80600,22.7,-11946,13115,15030,7.1,14.3,38.6
1981,Florida,4.1,286356,3014820,234119,36207,17.2,20701,31440,14.9,20613,406880,693236,23,120653,336391,570510,18.9,122726,178244,212419,9.5,7.8,37.8
1981,Geogia,1.1,131821,1720873,123359,13777,13.6,8869,14441,14.2,8847,191587,323408,18.8,48297,181331,304690,17.7,18718,81987,100899,7.7,7.2,35.4
1981,Hawaii,1.9,27216,305274,20957,3000,14.7,1733,2850,14,1700,30590,57806,18.9,10583,31085,52042,17,5764,17073,20406,8.9,6.9,34
1981,Idaho,5.2,36287,250145,18565,2667,13.6,2077,3213,16.4,2057,25111,61398,24.5,9980,29812,48377,19.3,13021,16460,19227,14.5,7.4,38.6
1981,Illinois,-3.1,227322,4025498,262570,23382,11.3,16529,28369,13.7,16410,349516,576838,14.3,109079,438562,701132,17.4,-124294,173447,203368,5.6,6.5,28.6
1981,Indiana,-2.8,95769,1765454,106961,10378,10.7,7722,13009,13.4,7688,153063,248832,14.1,41752,191803,298764,16.9,-49932,78583,95289,5.4,6.1,28.2
1981,Iowa,-3.5,68295,872749,64448,7035,10.9,5338,8526,13.2,5316,65443,133738,15.3,25683,99691,164139,18.8,-30401,53766,63474,7.8,7.4,30.6
1981,Kansas,-0.4,55555,739441,47525,6710,12.6,4625,7473,14,4605,66156,121711,16.5,24088,77685,125210,16.9,-3499,45126,52682,7.5,6.4,33
1981,Kentucky,-2.4,58431,944698,59346,6978,11.7,5119,8213,13.8,5102,87159,145590,15.4,26963,108747,168093,17.8,-22503,49848,58912,6.2,6.3,30.8
1981,Louisiana,3.6,101116,1259344,82248,10629,14.1,6491,10254,13.6,6453,163285,264401,21,39080,136792,219040,17.4,45361,63310,75338,8,6.5,34.8
1981,Maine,0,17665,311506,20827,2611,11.7,1858,3003,13.5,1849,32882,50547,16.2,8441,29500,50327,16.2,220,19128,21998,5.7,6.7,32.4
1981,Maryland,-2.2,86602,1275299,85161,8897,12.3,5591,9797,13.6,5568,127592,214194,16.8,32202,157693,242854,19,-28660,59739,71488,6.8,6.7,33.6
1981,Massachusetts,-0.1,125367,2260249,156298,12150,10.8,7478,13281,11.8,7436,241852,367219,16.2,57603,213228,369526,16.3,-2307,96214,111344,5.5,6.9,32.4
1981,Michigan,-4.5,164571,2802878,184908,17059,11.3,12080,21384,14.2,12000,221266,385837,13.8,65260,326801,511709,18.3,-125872,123243,147901,5.9,6.6,27.6
1981,Minnesota,-1.2,98844,1463405,97186,9428,11.6,5974,10300,12.6,5945,137842,236686,16.2,41864,156760,253946,17.4,-17260,68780,80765,6.8,6.6,32.4
1981,Mississippi,-1.7,36504,601942,36934,5057,12,3949,6053,14.4,3941,58281,94785,15.7,19855,67661,104595,17.4,-9810,35092,41408,6.1,6.1,31.4
1981,Missouri,-0.7,102839,1622808,103489,11598,12.1,8151,13557,14.1,8124,156455,259294,16,41830,167229,270718,16.7,-11424,79623,94775,6.3,6.4,32
1981,Montana,-1,15830,200481,17336,2734,14,1814,2907,14.8,1814,22158,37988,18.9,9491,22600,39936,19.9,-1948,17112,19422,7.9,8.6,37.8
1981,Nebraska,0.8,33029,482591,31669,4092,11.4,2818,4785,13.3,2813,49386,82415,17.1,13933,47091,78760,16.3,3655,30846,35583,6.8,6.6,32.6
1981,Nevada,-1.3,30682,334726,28250,3230,18.3,1865,2985,16.9,1861,39723,70405,21,11907,46445,74695,22.3,-4290,15347,17668,9.2,8.4,42
1981,New Hampshire,1.2,21577,317448,23154,2597,13.1,1639,2699,13.6,1636,36910,58487,18.4,8820,31499,54653,17.2,3834,17549,19671,6.8,7.3,34.4
1981,New Jersey,0.8,164498,2514843,166423,17249,11.6,11404,19125,12.9,11362,265622,430120,17.1,58814,242552,408975,16.3,21145,129561,147107,6.5,6.6,32.6
1981,New Mexico,1.6,29721,325449,27636,3923,15.2,2639,4092,15.9,2629,40846,70567,21.7,15593,37925,65561,20.1,5006,22018,25535,9.1,8.5,40.2
1981,New York,-0.9,342525,5862840,403483,38945,11.1,28579,45640,13,28454,614439,956964,16.3,155841,607490,1010973,17.2,-54009,307251,346538,5.8,6.9,32.6
1981,North Carolina,-0.3,116106,1966888,117400,13278,12.3,9091,14688,13.6,9063,181560,297666,15.1,49490,184865,302265,15.4,-4599,87816,107193,5.9,6,30.2
1981,North Dakota,-0.6,12930,170036,10886,1969,12.7,1253,2036,13.1,1252,15666,28596,16.8,6111,18681,29567,17.4,-971,13541,15447,7.6,6.4,33.6
1981,Ohio,-4.2,188313,3615444,222057,20338,10.6,13973,25160,13.1,13901,273872,462185,12.8,77288,393632,615689,17,-153504,151532,189344,5.2,6.1,25.6
1981,Oklahoma,4.8,79984,894851,65049,9586,15.4,6113,9200,14.8,6098,113722,193706,21.6,32564,85163,150212,16.8,43494,53266,62109,8.9,7.3,33.6
1981,Oregon,-4.1,66356,812999,67923,9010,15.2,6168,9905,16.7,6146,70584,136940,16.8,34569,102140,170063,20.9,-33123,50412,58527,8.2,8.4,33.6
1981,Pennsylvania,-1.2,230610,3985643,230928,20903,10,15409,26660,12.7,15340,345362,575972,14.5,89073,394983,625911,15.7,-49939,170981,206089,5.8,5.8,29
1981,Rhode Island,-1.6,19112,337114,21114,2144,10.7,1484,2490,12.4,1480,30486,49598,14.7,8297,33873,54987,16.3,-5389,17847,19791,5.7,6.3,29.4
1981,South Carolina,-0.6,57611,952226,58409,6773,12.8,4671,7641,14.5,4654,85175,142786,15,26123,89943,148352,15.6,-5566,43447,52240,6.1,6.1,30
1981,South Dakota,-2.8,11275,171563,11494,1762,11,1336,2150,13.4,1332,13817,25092,14.6,6566,18426,29920,17.4,-4828,13981,15802,6.6,6.7,29.2
1981,Tennessee,-0.5,87817,1403176,89695,10105,12.5,7445,11619,14.4,7416,138381,226198,16.1,41705,143562,233257,16.6,-7059,66187,79665,6.3,6.4,32.2
1981,Texas,6.4,500349,4879338,310737,52884,19.5,19910,34927,12.9,19810,596194,1096543,22.5,130880,474916,785653,16.1,310890,235071,291027,10.3,6.4,32.2
1981,Utah,0,36675,416596,33316,4227,15.8,2654,4266,16,2642,43299,79974,19.2,16753,46667,79983,19.2,-9,22649,26560,8.8,8,38.4
1981,Vermont,0.6,8699,161293,9323,1531,12.4,1061,1681,13.6,1057,16358,25057,15.5,5075,14641,23964,14.9,1093,11049,12252,5.4,5.8,29.8
1981,Virginia,1.8,120522,1586248,110576,12065,12.8,7805,13047,13.9,7757,166104,286626,18.1,46449,147232,257808,16.3,28818,76139,93322,7.6,7,32.6
1981,Washington,-0.6,97017,1222439,88570,12573,14.7,7920,13197,15.4,7886,133502,230519,18.9,41059,150063,238633,19.5,-8114,72257,84939,7.9,7.2,37.8
1981,West Virginia,-1.9,29683,471844,29224,3614,11.6,2787,4368,14.1,2784,40642,70325,14.9,13077,49880,79104,16.8,-8779,26008,30615,6.3,6.2,29.8
1981,Wisconsin,-3.3,84137,1562754,83001,9715,10.6,6536,11341,12.4,6512,118949,203086,13,33536,171996,254997,16.3,-51911,78256,90700,5.4,5.3,26
1981,Wyoming,4.1,14592,149044,11469,2130,17.3,1232,1889,15.3,1229,22270,36862,24.7,6489,19170,30639,20.6,6223,11025,12419,9.8,7.7,41.2
1982,Alabama,-0.7,73771,1035586,62802,8770,13.8,4766,7905,12.4,4763,103713,177484,17.1,27015,121619,184421,17.8,-6937,51528,63550,7.1,6.1,34.2
1982,Alaska,12.7,17287,118895,9822,2062,23.6,581,1113,12.7,578,23421,40708,34.2,5306,15681,25503,21.5,15205,7770,9202,14.5,8.3,43
1982,Arizona,1.8,97137,810479,56252,11014,20.8,3983,7184,13.5,3976,86571,183708,22.7,23401,112766,169018,20.9,14690,44307,54704,12,6.9,41.8
1982,Arkansas,-0.2,43730,574437,33088,6305,15.5,3059,5165,12.7,3055,56054,99784,17.4,16426,68029,101117,17.6,-1333,34933,40902,7.6,5.8,34.8
1982,California,3.6,887957,8361841,528202,87529,17.5,34960,63168,12.7,34915,992557,1880514,22.5,231250,1052788,1580990,18.9,299524,416159,507962,10.6,6.3,37.8
1982,Colorado,8.6,159697,1079447,76716,13933,20.1,5142,9428,13.6,5138,131126,290823,26.9,32193,120423,197139,18.3,93684,60030,71120,14.8,7.1,36.6
1982,Connecticut,1.4,85654,1250950,51129,8917,13.7,3654,6249,9.6,3650,107789,193443,15.5,22434,125564,176693,14.1,16750,57543,66275,6.8,4.1,28.2
1982,Delaware,1.5,13545,214437,8755,1583,13.9,658,1181,10.4,654,17065,30610,14.3,3178,18645,27400,12.8,3210,9918,11554,6.3,4.1,25.6
1982,District of Columbia,-1.1,32202,337053,18749,2403,15.7,899,1738,11.3,895,28311,60513,18,7992,45698,64447,19.1,-3934,13524,15582,9.6,5.6,36
1982,Florida,2.2,330673,3106680,207785,41962,19.2,16557,27844,12.7,16531,351960,682633,22,107630,406812,614597,19.8,68036,185530,224964,10.6,6.7,39.6
1982,Geogia,2.3,164650,1746660,98190,16197,15.8,6859,12492,12.2,6854,169922,334572,19.2,42263,196976,295166,16.9,39406,82630,103586,9.4,5.6,33.8
1982,Hawaii,1.8,33667,311254,18882,3292,15.9,1355,2380,11.5,1355,26867,60534,19.4,8406,35855,54737,17.6,5797,17274,21094,10.8,6.1,35.2
1982,Idaho,-5.1,33498,249562,15771,3163,16.3,1410,2591,13.4,1409,19320,52818,21.2,7452,49931,65702,26.3,-12884,16468,19544,13.4,6.3,42.4
1982,Illinois,-1.8,289970,3926601,206379,28342,13.8,12830,22357,10.9,12810,317634,607604,15.5,79738,471106,677485,17.3,-69881,174328,207478,7.4,5.3,31
1982,Indiana,-2.1,104209,1722512,76137,12672,13.2,6046,10134,10.5,6026,133352,237561,13.8,33864,197304,273441,15.9,-35880,78792,97057,6,4.4,27.6
1982,Iowa,1.4,65929,862235,45273,7812,12.4,4287,7275,11.5,4286,91084,157013,18.2,20707,99316,144589,16.8,12424,52350,62933,7.6,5.3,33.6
1982,Kansas,1.4,57443,741914,43734,7796,14.7,3748,6269,11.8,3726,74702,132145,17.8,22239,78239,121973,16.4,10172,45119,53521,7.7,5.9,32.8
1982,Kentucky,1.3,76129,938637,47220,8804,14.8,4169,6926,11.6,4166,91109,167238,17.8,21752,107959,155179,16.5,12059,50098,60158,8.1,5,33
1982,Louisiana,2.9,115912,1297744,82782,13262,17.1,4939,8662,11.2,4922,161691,277603,21.4,38950,157381,240163,18.5,37440,65758,79316,8.9,6.4,37
1982,Maine,1,23931,312392,19425,3004,13.6,1451,2481,11.2,1444,29712,53643,17.2,9929,31236,50661,16.2,2982,19071,22254,7.7,6.2,32.4
1982,Maryland,1.4,104776,1269528,64953,10849,14.9,4266,7703,10.6,4264,122608,227384,17.9,26947,144246,209199,16.5,18185,60832,74008,8.3,5.1,33
1982,Massachusetts,2.3,151188,2299675,93675,15237,13.4,5956,10541,9.3,5950,213405,364593,15.9,41290,219652,313327,13.6,51266,98088,115290,6.6,4.1,27.2
1982,Michigan,-3.8,164916,2686353,146863,20280,13.6,9227,16693,11.2,9214,214389,379305,14.1,55876,334639,481502,17.9,-102197,122650,150153,6.1,5.5,28.2
1982,Minnesota,-1.2,96515,1443395,69733,10889,13.4,4811,8522,10.5,4801,131025,227540,15.8,28508,176255,245988,17,-18448,68678,82181,6.7,4.8,31.6
1982,Mississippi,-2,41851,589624,33064,5936,14.3,2959,5006,12.1,2957,46227,88078,14.9,14331,66704,99768,16.9,-11690,34671,41638,7.1,5.6,29.8
1982,Missouri,2.7,155239,1633451,86411,13306,14,6540,11294,11.9,6521,149190,304429,18.6,37397,172703,259114,15.9,45315,78840,95517,9.5,5.3,31.8
1982,Montana,0.6,20141,198950,13653,3054,15.6,1436,2501,12.8,1433,20980,41121,20.7,8010,26328,39981,20.1,1140,17059,19628,10.1,6.9,40.2
1982,Nebraska,-1,34441,480356,24957,4735,13.3,2351,3890,10.9,2348,40574,75015,15.6,12182,54627,79584,16.6,-4569,30581,35790,7.2,5.2,31.2
1982,Nevada,1.9,38523,335154,23504,3692,20.3,1406,2505,13.8,1405,38090,76613,22.9,10635,46812,70316,21,6297,15935,18664,11.5,7,42
1982,New Hampshire,2,22836,326759,16782,3047,15.2,1281,2178,10.9,1280,31526,54362,16.6,8359,31062,47844,14.6,6518,17903,20303,7,5.1,29.2
1982,New Jersey,1.9,176682,2548151,140613,20644,13.8,8820,15539,10.4,8811,280019,456701,17.9,50131,266020,406633,16,50068,131665,151014,6.9,5.5,32
1982,New Mexico,3.5,33842,334673,23111,4549,17.4,1887,3231,12.4,1887,39472,73314,21.9,11252,38615,61726,18.4,11588,22552,26589,10.1,6.9,36.8
1982,New York,2.4,426999,5902562,296624,46816,13.4,22112,36881,10.5,22083,592132,1019131,17.3,130311,585159,881783,14.9,137348,310148,353411,7.2,5,29.8
1982,North Carolina,0.9,141191,1968928,90994,15526,14.3,7305,11811,10.9,7290,163356,304547,15.5,39094,195563,286557,14.6,17990,88660,109820,7.2,4.6,29.2
1982,North Dakota,3,13945,171412,8775,2209,14.2,984,1713,11,983,17298,31243,18.2,5189,17279,26054,15.2,5189,13516,15679,8.1,5.1,30.4
1982,Ohio,-1.7,225909,3506120,164297,24446,12.8,10930,20170,10.6,10913,290388,516297,14.7,66014,410156,574453,16.4,-58156,150716,191602,6.4,4.7,29.4
1982,Oklahoma,6.6,97440,947988,57888,12114,18.9,4623,7613,11.9,4621,126243,223683,23.6,28930,103160,161048,17,62635,55975,66082,10.3,6.1,34
1982,Oregon,-2.1,75413,784462,56122,9608,16.4,4970,8931,15.3,4952,77310,152723,19.5,27160,113668,169790,21.6,-17067,49241,58378,9.6,7.2,39
1982,Pennsylvania,-0.4,255840,3945137,185545,26202,12.6,11502,20407,9.8,11471,358865,614705,15.6,71537,446699,632244,16,-17539,170926,209563,6.5,4.7,31.2
1982,Rhode Island,-1.3,20312,331141,15246,2462,12.4,1206,2061,10.3,1205,26895,47207,14.3,7347,36363,51609,15.6,-4402,17894,20031,6.1,4.6,28.6
1982,South Carolina,0.7,74337,922082,44066,8233,15.5,3776,6102,11.5,3772,77914,152251,16.5,23598,101629,145695,15.8,6556,43950,53821,8.1,4.8,31.6
1982,South Dakota,-0.1,13079,167378,9235,1951,12.4,1051,1742,11.1,1050,14303,27382,16.4,5099,18354,27589,16.5,-207,13678,15664,7.8,5.5,32.8
1982,Tennessee,-0.7,110897,1394634,71588,12316,15.3,5825,9901,12.3,5818,118238,229135,16.4,34291,166400,237988,17.1,-8853,66172,81133,8,5.1,32.8
1982,Texas,6.9,582424,5202200,315634,58523,19.4,20292,34608,11.5,20275,675553,1257977,24.2,141169,586736,902370,17.3,355607,247519,312446,11.2,6.1,34.6
1982,Utah,2.2,38779,420674,26666,4842,17.9,1980,3523,13,1980,45661,84440,20.1,13106,48792,75458,17.9,8982,22985,27573,9.2,6.3,35.8
1982,Vermont,0.6,10823,162040,9014,1891,15.2,803,1340,10.8,790,15092,25915,16,4287,15961,24975,15.4,940,11298,12644,6.7,5.6,30.8
1982,Virginia,1.5,120466,1614790,80069,14270,15.1,6053,10560,11.1,6049,176266,296732,18.4,35442,193550,273619,16.9,23113,76933,96007,7.5,5,33.8
1982,Washington,-1.2,110239,1210293,72311,14841,17.2,6158,10965,12.7,6136,113466,223705,18.5,34735,165530,237841,19.7,-14136,73192,87671,9.1,6,37
1982,West Virginia,-0.7,33940,464766,27910,4211,13.8,2185,3816,12.5,2184,41867,75807,16.3,12243,50929,78839,17,-3032,25339,30396,7.3,6,32.6
1982,Wisconsin,0.1,102851,1533863,65090,11980,13.1,5373,9241,10.1,5364,122403,225254,14.7,28417,158276,223366,14.6,1888,78176,92160,6.7,4.2,29.2
1982,Wyoming,5.9,23952,156246,10923,2489,19.5,981,1681,13.2,981,18639,42591,27.3,5404,22516,33439,21.4,9152,11398,13087,15.3,7,42.8
1983,Alabama,-2,68404,1008350,63721,7818,12.2,4884,7383,11.5,4861,99914,168318,16.7,28672,124541,188262,18.7,-19944,52559,64548,6.8,6.3,33.4
1983,Alaska,2.5,15783,128659,10660,2259,23.1,757,1221,12.5,757,19577,35360,27.5,4841,21451,32111,25,3249,8798,10380,12.3,8.3,50
1983,Arizona,2.8,80718,822756,53973,9435,16.9,4763,7192,12.9,4743,105070,185788,22.6,29774,109177,163150,19.8,22638,46545,57195,9.8,6.6,39.6
1983,Arkansas,0.5,37684,570494,29320,5448,13.2,3361,4814,11.6,3353,56652,94336,16.5,16481,62140,91460,16,2876,35923,41871,6.6,5.1,32
1983,California,-3.4,599820,8321084,564210,70793,13.8,40136,63438,12.4,39906,960712,1560532,18.8,249852,1283503,1847713,22.2,-287181,426462,517992,7.2,6.8,37.6
1983,Colorado,-4.7,93647,1088757,72534,11852,16.4,6438,9693,13.4,6409,117553,211200,19.4,37759,189964,262498,24.1,-51298,62282,73644,8.6,6.7,38.8
1983,Connecticut,0.2,61693,1261708,52247,7543,11.2,4055,6203,9.2,4048,130402,192095,15.2,21376,136825,189072,15,3023,59291,68139,4.9,4.1,30
1983,Delaware,0.5,13261,216723,10263,1439,12.3,715,1171,10,710,19629,32890,15.2,4373,21591,31854,14.7,1036,10295,11941,6.1,4.7,29.4
1983,District of Columbia,8,19080,347245,15441,2028,12.8,965,1581,10,963,58607,77687,22.4,6655,34482,49923,14.4,27764,14133,16174,5.5,4.4,28.8
1983,Florida,0.3,274794,3139059,233193,36827,16.2,19900,31999,14,19819,353448,628242,20,117227,384472,617665,19.7,10577,190507,230989,8.8,7.4,39.4
1983,Geogia,1,129884,1761597,99959,14892,14.1,7628,11578,11,7611,192752,322636,18.3,45682,205284,305243,17.3,17393,86232,107526,7.4,5.7,34.6
1983,Hawaii,-1.4,21579,313054,17948,2793,13,1514,2259,10.5,1493,31933,53512,17.1,9973,39843,57791,18.5,-4279,17978,21839,6.9,5.7,34.2
1983,Idaho,-4.4,16777,235298,15055,2607,13.2,1611,2413,12.2,1604,24190,40967,17.4,8259,36157,51212,21.8,-10245,16851,19897,7.1,6.4,34.8
1983,Illinois,-4.4,202279,3800343,229375,22707,11,14109,25620,12.4,14010,325065,527344,13.9,86046,465990,695365,18.3,-168021,171918,205087,5.3,6,27.8
1983,Indiana,-5.1,74920,1656094,108794,9691,10.2,7108,13097,13.8,7057,144495,219415,13.2,41432,194011,302805,18.3,-83390,74718,92676,4.5,6.6,26.4
1983,Iowa,-7.6,51006,832149,51742,6400,10.1,4306,6389,10.1,4296,69451,120457,14.5,21445,132449,184191,22.1,-63734,53389,63885,6.1,6.2,29
1983,Kansas,-4.5,47699,724018,49222,6689,12.4,3987,5902,10.9,3966,64332,112031,15.5,20525,95748,144970,20,-32939,46404,54762,6.6,6.8,31
1983,Kentucky,-4.3,55409,923725,52529,7339,12.1,4623,6809,11.2,4613,80831,136240,14.7,26748,123232,175761,19,-39521,51207,61174,6,5.7,29.4
1983,Louisiana,-7.3,86100,1260193,91104,10466,13.1,6452,9369,11.7,6431,125464,211564,16.8,46244,212483,303587,24.1,-92023,67495,80869,6.8,7.2,33.6
1983,Maine,1.6,17911,316502,15757,2679,11.9,1478,2292,10.2,1475,30718,48629,15.4,7526,27780,43537,13.8,5092,19672,22809,5.7,5,27.6
1983,Maryland,1,73410,1287630,65692,9547,12.7,4677,7238,9.6,4650,138944,212354,16.5,28239,133730,199422,15.5,12932,63676,76930,5.7,5.1,31
1983,Massachusetts,0.4,123386,2331911,99420,12775,10.9,6921,10533,9,6891,223427,346813,14.9,46491,237775,337195,14.5,9618,100925,118300,5.3,4.3,29
1983,Michigan,-1.3,132359,2630357,122734,17284,11.4,9780,15652,10.3,9722,236040,368399,14,55747,280661,403395,15.3,-34996,125642,153082,5,4.7,28
1983,Minnesota,-1.6,82139,1414329,69319,9302,11.2,5123,8050,9.7,5104,132154,214293,15.2,31334,168897,238216,16.8,-23923,70589,84129,5.8,4.9,30.4
1983,Mississippi,-0.4,39222,574022,30367,5121,12.2,3279,4724,11.2,3262,54459,93681,16.3,16513,65681,96048,16.7,-2367,35577,42476,6.8,5.3,32.6
1983,Missouri,-3.1,101147,1615228,94010,11785,12.2,6724,10396,10.8,6682,157050,258197,16,37811,215028,309038,19.1,-50841,81397,97812,6.3,5.8,32
1983,Montana,-0.4,17462,196569,13198,2735,13.7,1531,2310,11.6,1516,20605,38067,19.4,8733,25683,38881,19.8,-814,17739,20302,8.9,6.7,38.8
1983,Nebraska,-1.1,32518,470496,26235,3923,10.8,2312,3578,9.9,2302,43011,75529,16.1,13286,54680,80915,17.2,-5386,31505,36662,6.9,5.6,32.2
1983,Nevada,-3.5,26166,332451,21842,2837,15.1,1789,2678,14.3,1784,31213,57379,17.3,11403,47303,69145,20.8,-11766,16170,18897,7.9,6.6,34.6
1983,New Hampshire,2,21021,332368,16168,2759,13.3,1399,2048,9.9,1397,36255,57276,17.2,8668,34190,50358,15.2,6918,18710,21156,6.3,4.9,30.4
1983,New Jersey,1.2,156990,2592664,146793,18127,11.8,9916,15163,9.9,9895,288766,445756,17.2,55193,268142,414935,16,30821,135767,155125,6.1,5.7,32
1983,New Mexico,-0.5,31265,333916,24770,4074,15,2172,3327,12.3,2169,37286,68551,20.5,13358,45213,69983,21,-1432,23525,27583,9.4,7.4,41
1983,New York,-0.2,317954,5966648,306263,41467,11.6,25565,36329,10.2,25487,643428,961382,16.1,144363,664794,971057,16.3,-9675,318787,362165,5.3,5.1,32.2
1983,North Carolina,-0.9,116714,1951673,110138,12413,11.5,8088,14724,13.6,8045,175550,292264,15,44571,199424,309562,15.9,-17298,84963,106262,6,5.6,30
1983,North Dakota,-1.9,11346,171271,11141,1812,11.4,1127,1696,10.7,1124,15731,27077,15.8,6348,19175,30316,17.7,-3239,13888,16016,6.6,6.5,31.6
1983,Ohio,-2.9,167402,3429360,153146,19593,10.2,11777,19322,10,11696,298035,465437,13.6,67892,411735,564881,16.5,-99444,153324,193626,4.9,4.5,27.2
1983,Oklahoma,-6,73567,938901,67259,9261,13.9,6394,8770,13.2,6372,94545,168112,17.9,41004,157211,224470,23.9,-56358,56795,66872,7.8,7.2,35.8
1983,Oregon,-3.9,53820,756681,47430,8048,13.7,4991,7693,13.1,4962,79122,132942,17.6,26424,115189,162619,21.5,-29677,50079,59185,7.1,6.3,35.2
1983,Pennsylvania,-4,199683,3858567,190734,21723,10.3,12399,20017,9.5,12337,335862,535545,13.9,73810,500872,691606,17.9,-156061,175213,213454,5.2,4.9,27.8
1983,Rhode Island,0.9,14197,330649,13866,2128,10.5,1296,1917,9.5,1294,32486,46683,14.1,6785,29839,43705,13.2,2978,18301,20378,4.3,4.2,26.4
1983,South Carolina,-2.2,53293,906297,52414,6290,11.9,4254,7249,13.7,4240,81214,134507,14.8,24142,101690,154104,17,-19597,42225,52201,5.9,5.8,29.6
1983,South Dakota,-0.7,10540,166127,9057,1719,10.9,1080,1687,10.7,1076,14746,25286,15.2,5293,17396,26453,15.9,-1167,14024,15956,6.3,5.5,30.4
1983,Tennessee,1.7,99175,1390395,69097,10688,13,6359,9477,11.6,6328,146803,245978,17.7,36869,153105,222202,16,23776,68003,82972,7.1,5,32
1983,Texas,-3.6,444880,5235620,359445,48407,15.3,27194,40083,12.6,26952,579938,1024818,19.6,183673,855968,1215413,23.2,-190595,256749,322516,8.5,6.9,39.2
1983,Utah,-1,34207,420041,25592,3739,13.4,2241,3502,12.6,2234,43264,77471,18.4,13967,55802,81394,19.4,-3923,23460,28098,8.1,6.1,36.8
1983,Vermont,-0.8,8657,162155,6270,1585,12.4,904,1325,10.3,902,13587,22244,13.7,3849,17245,23515,14.5,-1271,11688,13024,5.3,3.9,27.4
1983,Virginia,-0.3,91007,1622507,76382,12244,12.5,6492,9888,10.1,6442,168440,259447,16,36726,188669,265051,16.3,-5604,80067,99284,5.6,4.7,32
1983,Washington,1.7,112306,1210142,66949,12758,14.3,6784,10543,11.8,6727,128245,240551,19.9,36932,153739,220688,18.2,19863,76292,90803,9.3,5.5,36.4
1983,West Virginia,-9.5,25529,443563,25622,3385,11.1,2320,3516,11.5,2316,30037,55566,12.5,12624,72043,97665,22,-42099,25750,30779,5.8,5.8,25
1983,Wisconsin,-3,71956,1514579,64074,9617,10.3,5461,8566,9.2,5439,126211,198167,13.1,31441,179640,243714,16.1,-45547,80231,94261,4.8,4.2,26.2
1983,Wyoming,-16.7,12989,146464,12160,1855,14.2,1310,1917,14.6,1309,12468,25457,17.4,7754,37767,49927,34.1,-24470,11467,13117,8.9,8.3,34.8
1984,Alabama,7.4,74882,1040328,56023,10032,15.2,4910,7408,11.2,4888,139325,214207,20.6,28444,81542,137565,13.2,76642,55138,67233,7.2,5.4,26.4
1984,Alaska,7.6,16633,135862,10328,2456,22.6,902,1459,13.4,901,20813,37446,27.6,5761,16903,27231,20,10215,9721,11362,12.2,7.6,40
1984,Arizona,11,88592,886564,50448,10981,18.6,4652,7237,12.3,4630,142285,230877,26,27226,82130,132578,15,98299,49990,60964,10,5.7,30
1984,Arkansas,7.5,42642,591885,30823,6764,15.8,3379,4944,11.6,3360,77121,119763,20.2,16933,44609,75432,12.7,44331,37626,43722,7.2,5.2,25.4
1984,California,7.8,683957,8501049,478894,81523,15.4,38462,61524,11.7,38298,1258455,1942412,22.8,232832,792115,1271009,15,671403,444670,537786,8,5.6,30
1984,Colorado,5.9,101925,1095963,67139,13247,17.6,6496,9734,12.9,6474,143720,245645,22.4,35849,113158,180297,16.5,65348,65539,77255,9.3,6.1,33
1984,Connecticut,4.8,74194,1292967,54138,8572,12.4,4197,6358,9.2,4186,149587,223781,17.3,24915,108090,162228,12.5,61553,61305,70362,5.7,4.2,25
1984,Delaware,6.3,13713,223808,9639,1626,13.4,782,1297,10.7,779,26921,40634,18.2,3757,16884,26523,11.9,14111,10613,12270,6.1,4.3,23.8
1984,District of Columbia,-3.6,19600,353491,18006,1873,11.7,1173,2071,12.9,1173,36809,56409,16,6855,51345,69351,19.6,-12942,13793,15913,5.5,5.1,32
1984,Florida,10.4,356722,3320817,197497,44838,18.8,19669,28709,12,19564,482898,839620,25.3,108460,296046,493543,14.9,346077,204982,247109,10.7,5.9,29.8
1984,Geogia,8.9,142143,1852078,91212,17152,15.6,7556,11954,10.8,7527,247778,389921,21.1,45174,135443,226655,12.2,163266,90975,112875,7.7,4.9,24.4
1984,Hawaii,0,18100,310797,17582,2526,11.6,1581,2523,11.6,1549,31053,49153,15.8,8836,31546,49128,15.8,25,17969,21828,5.8,5.7,31.6
1984,Idaho,7.4,17990,239238,13559,2870,14.2,1565,2292,11.4,1562,34175,52165,21.8,8122,20832,34391,14.4,17774,17361,20481,7.5,5.7,28.8
1984,Illinois,6.4,237850,3851622,164385,27776,13.2,10338,19475,9.3,10288,472367,710217,18.4,52728,299581,463966,12,246251,180753,214659,6.2,4.3,24
1984,Indiana,7.4,110863,1684517,67623,12219,12.7,177,6396,6.6,154,205930,316793,18.8,1833,123948,191571,11.4,125222,82032,100417,6.6,4,22.8
1984,Iowa,3.4,51683,813190,37539,7685,11.9,4440,6643,10.3,4428,85343,137026,16.9,20054,72547,110086,13.5,26940,54248,64905,6.4,4.6,27
1984,Kansas,9.3,53604,742495,45527,7850,14.2,4165,7105,12.9,4155,119801,173405,23.4,22608,59281,104808,14.1,68597,47008,55572,7.2,6.1,28.2
1984,Kentucky,4.5,61879,926022,48435,8716,14.1,4734,7019,11.3,4725,102755,164634,17.8,27193,74370,122805,13.3,41829,52680,62833,6.7,5.2,26.6
1984,Louisiana,1.4,89425,1226034,73874,11552,14.1,6629,9918,12.1,6603,140358,229783,18.7,36860,138054,211928,17.3,17855,68750,82544,7.3,6,34.6
1984,Maine,5.9,19436,327997,13102,3324,14.3,1452,2223,9.5,1444,37100,56536,17.2,6650,24009,37111,11.3,19425,20624,23857,5.9,4,22.6
1984,Maryland,6.8,98263,1335248,70982,9621,12.5,5214,9056,11.7,5195,163700,261963,19.6,30943,100098,171080,12.8,90883,63699,77363,7.4,5.3,25.6
1984,Massachusetts,6.7,139131,2430899,91928,14760,12.3,6898,10642,8.8,6883,304485,443616,18.2,41653,186557,278485,11.5,165131,104727,122586,5.7,3.8,23
1984,Michigan,8,158996,2682072,126626,20564,13.2,9713,15346,9.8,9657,354422,513418,19.1,51279,171329,297955,11.1,215463,130947,158621,5.9,4.7,22.2
1984,Minnesota,7.4,98644,1456843,70081,11483,13.4,5429,8475,9.9,5380,188139,286783,19.7,32224,109425,179506,12.3,107277,73463,87209,6.8,4.8,24.6
1984,Mississippi,6.9,41264,592868,30191,6232,14.4,3270,4867,11.3,3259,73916,115180,19.4,14956,43661,73852,12.5,41328,36901,43906,7,5.1,25
1984,Missouri,5.4,111525,1652924,82694,13227,13.4,7280,11513,11.6,7251,201047,312572,18.9,42204,139910,222604,13.5,89968,83049,99775,6.7,5,27
1984,Montana,2.7,15372,198664,11707,3215,15.5,1555,2377,11.5,1552,22766,38138,19.2,6989,21137,32844,16.5,5294,18551,21143,7.7,5.9,33
1984,Nebraska,0.9,29588,476473,27182,4242,11.6,2550,4368,11.9,2538,47733,77321,16.2,12842,45890,73072,15.3,4249,31279,36541,6.2,5.7,30.6
1984,Nevada,10.3,28885,343825,20059,3528,18.1,1581,2413,12.4,1581,54468,83353,24.2,9125,27768,47827,13.9,35526,17171,20005,8.4,5.8,27.8
1984,New Hampshire,11.8,29749,350221,16317,3475,15.9,1431,2147,9.8,1426,50474,80223,22.9,7893,22467,38784,11.1,41439,19940,22503,8.5,4.7,22.2
1984,New Jersey,5.7,179469,2680205,125343,20007,12.7,10026,15534,9.9,10004,330587,510056,19,54110,231012,356355,13.3,153701,139819,159770,6.7,4.7,26.6
1984,New Mexico,5.3,32475,343775,21059,4472,16,2366,3567,12.7,2361,43729,76204,22.2,12325,37149,58208,16.9,17996,24339,28441,9.4,6.1,33.8
1984,New York,3.7,371141,6097225,286843,44945,12.3,26302,38364,10.5,26257,687512,1058653,17.4,161909,551347,838190,13.7,220463,325043,368867,6.1,4.7,27.4
1984,North Carolina,9.5,127451,2037736,55613,17575,15.6,239,6616,5.9,230,260398,387849,19,1749,138184,193797,9.5,194052,97433,119472,6.3,2.7,19
1984,North Dakota,2.5,12192,172112,9896,2072,12.8,1057,1820,11.3,1054,17412,29604,17.2,5056,15344,25240,14.7,4364,14104,16305,7.1,5.7,29.4
1984,Ohio,5.4,193324,3475636,135450,23392,11.9,11499,18807,9.6,11407,401571,594895,17.1,56969,271543,406993,11.7,187902,158035,198456,5.6,3.9,23.4
1984,Oklahoma,0.4,73247,914544,61449,10470,15.5,6219,8775,13,6210,99534,172781,18.9,33190,107864,169313,18.5,3468,58091,68485,8,6.7,37
1984,Oregon,6.2,56851,765430,41020,9596,15.9,4733,7060,11.7,4722,102598,159449,20.8,22430,70771,111791,14.6,47658,52482,61768,7.4,5.4,29.2
1984,Pennsylvania,4.6,220049,3867472,175486,25281,11.7,12986,21212,9.8,12917,440985,661034,17.1,76271,307716,483202,12.5,177832,178940,217598,5.7,4.5,25
1984,Rhode Island,5.8,19241,342904,13680,2511,12.2,1327,1985,9.6,1323,40335,59576,17.4,6390,26254,39934,11.6,19642,18812,20883,5.6,4,23.2
1984,South Carolina,8.4,68034,939565,33218,8610,15.6,130,3834,7,127,111169,179203,19.1,1221,67759,100977,10.7,78226,47764,58091,7.2,3.5,21.4
1984,South Dakota,5.6,11763,170357,9635,2157,13.4,1069,1865,11.6,1067,20308,32071,18.8,4851,12847,22482,13.2,9589,14276,16261,6.9,5.7,26.4
1984,Tennessee,5.8,102570,1448024,72903,13068,15.4,6470,9755,11.5,6436,178353,280923,19.4,35131,124729,197632,13.6,83291,71061,86278,7.1,5,27.2
1984,Texas,4.7,499978,5266633,340019,52188,16,28024,42659,13,27900,667167,1167145,22.2,172149,583730,923749,17.5,243396,264132,331867,9.5,6.5,35
1984,Utah,7.2,33790,433613,23538,4423,15.5,2146,3364,11.8,2145,58089,91879,21.2,12195,37357,60895,14,30984,24402,29152,7.8,5.4,28
1984,Vermont,7.2,11373,166945,7424,2007,15,901,1327,9.9,899,19018,30391,18.2,4290,10924,18348,11,12043,12300,13680,6.8,4.4,22
1984,Virginia,5.9,110148,1654170,97629,13549,13.7,7075,13608,13.8,7052,204156,314304,19,41773,118818,216447,13.1,97857,78723,98417,6.7,5.9,26.2
1984,Washington,5.6,100305,1252889,67933,15169,16.3,6919,10501,11.3,6911,163470,263775,21.1,35792,125764,193697,15.5,70078,80717,95533,8,5.4,31
1984,West Virginia,1.1,25610,422005,30115,3698,12.2,2269,4520,14.9,2264,43944,69554,16.5,11559,34716,64831,15.4,4723,24683,29710,6.1,7.1,30.8
1984,Wisconsin,6.1,89318,1538756,64385,11883,12.4,5824,9210,9.6,5804,182944,272262,17.7,28489,113524,177909,11.6,94353,82663,96931,5.8,4.2,23.2
1984,Wyoming,-0.1,13622,134617,10546,1921,14.6,1148,1840,14,1145,14505,28127,20.9,5522,17708,28254,21,-127,11517,13197,10.1,7.8,41.8
1985,Alabama,3.4,71006,1113206,62454,9620,14.1,5188,7859,11.5,5158,128462,199468,17.9,32391,99374,161828,14.5,37640,56904,69263,6.4,5.6,29
1985,Alaska,5.6,16780,149452,14139,2350,20.2,1180,1803,15.5,1175,24148,40928,27.4,6156,18386,32525,21.8,8403,10189,11923,11.2,9.5,43.6
1985,Arizona,10.2,96757,997245,69480,11646,18.5,5248,7977,12.7,5215,164248,261005,26.2,37122,90049,159529,16,101476,53291,64612,9.7,7,32
1985,Arkansas,2.1,41362,650439,42064,6148,13.8,3725,5289,11.9,3690,71372,112734,17.3,21256,56489,98553,15.2,14181,38828,44972,6.4,6.5,30.4
1985,California,3.9,709752,9081292,619411,83652,15.3,40076,65019,11.9,39811,1214044,1923796,21.2,282553,948036,1567447,17.3,356349,463300,556699,7.8,6.8,34.6
1985,Colorado,2.7,99309,1146241,85626,13226,16.9,7490,11071,14.1,7465,137286,236595,20.6,48116,119096,204722,17.9,31873,67414,79441,8.7,7.5,35.8
1985,Connecticut,3.6,65510,1361371,64802,9007,12.6,4643,6959,9.7,4630,154344,219854,16.1,29287,105615,170417,12.5,49437,63242,72502,4.8,4.8,25
1985,Delaware,4.9,13291,239484,11193,1744,13.9,770,1279,10.2,768,29433,42724,17.8,4629,19718,30911,12.9,11813,11023,12733,5.5,4.7,25.8
1985,District of Columbia,4.5,23434,355228,21232,1961,12.1,434,1472,9.1,423,42481,65915,18.6,6255,28859,50091,14.1,15824,14275,16470,6.6,6,28.2
1985,Florida,5.2,339836,3602407,253410,44981,17.8,22110,32388,12.8,22027,477917,817753,22.7,139888,375367,628777,17.5,188976,215201,259414,9.4,7,35
1985,Geogia,6.8,150247,2029062,109472,18304,15.8,7916,12568,10.8,7867,268751,418998,20.6,48801,170172,279644,13.8,139354,96305,118783,7.4,5.4,27.6
1985,Hawaii,3.2,22258,316038,17168,2927,13.2,1476,2324,10.5,1464,33270,55528,17.6,7705,28233,45401,14.4,10127,18464,22379,7,5.4,28.8
1985,Idaho,-0.6,16149,251095,15343,2778,13.4,1640,2477,11.9,1631,27635,43784,17.4,9030,29731,45074,18,-1290,17732,20897,6.4,6.1,34.8
1985,Illinois,1.5,237784,4066985,221356,26119,12,14800,23133,10.6,14716,418585,656369,16.1,98206,372486,593842,14.6,62527,184677,218917,5.8,5.4,29.2
1985,Indiana,2.2,108879,1798119,90397,12823,12.6,6827,10765,10.6,6795,173962,282841,15.7,43382,152528,242925,13.5,39916,84537,103018,6.1,5,27
1985,Iowa,0.5,42561,848464,48780,6627,10.2,4947,7423,11.5,4928,80383,122944,14.5,25370,70090,118870,14,4074,53774,64326,5,5.7,28
1985,Kansas,-0.6,55539,791169,70358,7935,14,4134,6271,11.1,4116,80652,136191,17.2,25739,70249,140607,17.8,-4416,48789,57371,7,8.9,34.4
1985,Kentucky,3.8,60758,1017819,53039,8038,12.6,4816,7040,11,4787,108651,169409,16.6,26351,76916,129955,12.8,39454,54185,64346,6,5.2,25.6
1985,Louisiana,0.2,89005,1245248,81884,11200,13.5,6865,10257,12.3,6828,134603,223608,18,41109,139376,221260,17.8,2348,69542,83464,7.1,6.6,35.6
1985,Maine,1.6,22041,344999,22708,3486,14.2,1573,2480,10.1,1569,35422,57463,16.7,9282,29426,52134,15.1,5329,21796,25031,6.4,6.6,30.2
1985,Maryland,7.1,108579,1432958,70737,11566,14.5,2387,6610,8.3,2356,188913,297492,20.8,22239,125030,195767,13.7,101725,68487,82601,7.6,4.9,27.4
1985,Massachusetts,3.6,134401,2563071,129460,15964,12.8,7560,11616,9.3,7531,306544,440945,17.2,61149,218811,348271,13.6,92674,108631,126964,5.2,5.1,27.2
1985,Michigan,4.5,205232,2853139,172498,20943,13,10639,16236,10.1,10581,317436,522668,18.3,64455,221346,393844,13.8,128824,135239,163398,7.2,6,27.6
1985,Minnesota,3.5,105570,1558560,96843,11258,12.7,6229,9535,10.8,6197,171341,276911,17.8,53948,125325,222168,14.3,54743,75220,89172,6.8,6.2,28.6
1985,Mississippi,1.8,40183,652421,37079,5853,13.2,3476,5147,11.6,3459,67671,107854,16.5,18729,58588,95667,14.7,12187,37585,44765,6.2,5.7,29.4
1985,Missouri,2.4,110782,1746317,109112,13853,13.6,7320,11055,10.9,7284,180517,291299,16.7,45636,140809,249921,14.3,41378,86028,103004,6.3,6.2,28.6
1985,Montana,-0.7,13882,218380,16080,2930,13.6,1820,2745,12.8,1817,21501,35383,16.2,8384,20930,37010,16.9,-1627,19069,21604,6.4,7.4,32.4
1985,Nebraska,2.8,36522,503877,31576,4739,12.6,2611,3896,10.3,2600,47737,84259,16.7,16595,38562,70138,13.9,14121,32820,38078,7.2,6.3,27.8
1985,Nevada,3.9,28701,369360,28174,3347,16.5,1896,2865,14.2,1891,44186,72887,19.7,13367,30265,58439,15.8,14448,17603,20476,7.8,7.6,31.6
1985,New Hampshire,5.4,27986,400410,23044,3935,16.7,1600,2410,10.3,1596,51048,79034,19.7,11110,34340,57384,14.3,21650,21587,24277,7,5.8,28.6
1985,New Jersey,4,171396,2849019,154831,21816,13.4,10757,16267,10,10716,354730,526126,18.5,67457,257075,411906,14.5,114220,145125,165701,6,5.4,29
1985,New Mexico,3.8,30388,373694,29470,4372,15.2,2399,3717,12.9,2390,48960,79348,21.2,14315,35416,64886,17.4,14462,24968,29077,8.1,7.9,34.8
1985,New York,2.8,342997,6318865,333782,47735,12.8,27278,39210,10.5,27169,699138,1042135,16.5,161653,529678,863460,13.7,178675,333438,378095,5.4,5.3,27.4
1985,North Carolina,3.5,132590,2208228,100906,17424,14.3,8014,12491,10.2,7985,234279,366869,16.6,46028,188976,289882,13.1,76987,102134,124671,6,4.6,26.2
1985,North Dakota,2.1,11633,188080,9750,2057,12.3,1148,1784,10.7,1146,18233,29866,15.9,5569,16128,25878,13.8,3988,14661,16858,6.2,5.2,27.6
1985,Ohio,3.7,176659,3617237,192293,23196,11.6,12496,20025,10,12393,422573,599232,16.6,85682,272783,465076,12.9,134156,161193,201446,4.9,5.3,25.8
1985,Oklahoma,-0.3,65611,956124,62992,9748,14.1,6630,9449,13.7,6612,94507,160118,16.7,35246,99361,162353,17,-2235,58653,69184,6.9,6.6,33.4
1985,Oregon,2.7,60129,822548,56705,9128,14.6,5498,8219,13.1,5457,98049,158178,19.2,30667,78761,135466,16.5,22712,53735,62941,7.3,6.9,33
1985,Pennsylvania,1.2,216878,3992309,230383,26007,11.8,13722,22225,10.1,13621,398263,615141,15.4,114415,334873,565256,14.2,49885,182765,221542,5.4,5.8,28.4
1985,Rhode Island,2,17115,356688,16810,2688,12.7,1437,2095,9.9,1436,37574,54689,15.3,10414,30744,47554,13.3,7135,19383,21512,4.8,4.7,26.6
1985,South Carolina,3.7,67964,1012828,52802,8858,14.9,4146,6269,10.5,4133,114607,182571,18,26753,91688,144490,14.3,38081,50222,60919,6.7,5.2,28.6
1985,South Dakota,3.3,14062,189598,9331,2183,13.1,1109,1739,10.4,1103,17796,31858,16.8,5409,16259,25590,13.5,6268,14861,16857,7.4,4.9,27
1985,Tennessee,3.8,96778,1541644,81419,12390,14.1,6551,9892,11.3,6499,170238,267016,17.3,36716,126442,207861,13.5,59155,73597,89144,6.3,5.3,27
1985,Texas,3.1,471006,5484012,372071,53231,15.8,27037,41813,12.4,26856,669689,1140695,20.8,180343,598711,970782,17.7,169913,273940,343120,8.6,6.8,35.4
1985,Utah,4.1,32749,459964,27928,4424,15,2584,3954,13.4,2573,55421,88170,19.2,16124,41632,69560,15.1,18610,24879,29637,7.1,6.1,30.2
1985,Vermont,2.9,11173,186234,10646,2121,14.9,975,1463,10.3,974,19057,30230,16.2,4559,14033,24679,13.3,5551,13196,14589,6,5.7,26.6
1985,Virginia,6,129207,1795831,71671,15583,15,341,6346,6.1,297,202702,331909,18.5,7925,152567,224238,12.5,107671,88347,108858,7.2,4,25
1985,Washington,3,100367,1331499,84729,14324,14.8,7885,12187,12.6,7833,156972,257339,19.3,44795,132645,217374,16.3,39965,82898,97878,7.5,6.4,32.6
1985,West Virginia,1.9,29136,439735,16883,3885,12.6,139,2239,7.2,132,36995,66131,15,1293,40813,57696,13.1,8435,26913,31939,6.6,3.8,26.2
1985,Wisconsin,1.9,82109,1593803,82211,11583,11.8,6466,9533,9.7,6416,153419,235528,14.8,40560,123061,205272,12.9,30256,84433,98765,5.2,5.2,25.8
1985,Wyoming,-0.2,10909,136316,10681,1863,14.1,1174,1810,13.7,1172,15228,26137,19.2,6200,15725,26406,19.4,-269,11610,13269,8,7.8,38.4
1986,Alabama,4.8,86524,1157441,61159,10412,14.8,5326,7918,11.3,5302,139901,226425,19.6,33580,110416,171575,14.8,54850,58637,71456,7.5,5.3,29.6
1986,Alaska,-3.2,15613,150114,14050,2279,19,1314,2059,17.2,1314,18495,34108,22.7,7233,24755,38805,25.9,-4697,10332,12056,10.4,9.4,45.4
1986,Arizona,5.2,115495,1074830,75347,12286,18.5,5795,8632,13,5788,145392,260887,24.3,41667,129808,205155,19.1,55732,56018,67984,10.7,7,38.2
1986,Arkansas,4.5,50602,671833,37859,6172,13.6,3794,5405,11.9,3776,79937,130539,19.4,20445,62077,99936,14.9,30603,39347,45527,7.5,5.6,29.8
1986,California,3.8,830797,9425326,610238,92023,16.2,42884,68261,12,42785,1190829,2021626,21.4,298844,1051057,1661295,17.6,360331,481361,578182,8.8,6.5,35.2
1986,Colorado,2.2,115574,1173451,93887,13382,16.7,7663,11491,14.3,7643,136429,252003,21.5,51905,132455,226342,19.3,25661,68458,80975,9.8,8,38.6
1986,Connecticut,2.8,91312,1404785,64088,9977,13.5,4646,7109,9.6,4640,135669,226981,16.2,34398,124038,188126,13.4,38855,65664,75134,6.5,4.6,26.8
1986,Delaware,10.3,34404,257420,12329,2016,15.4,794,1288,9.9,793,29291,63695,24.7,4447,24791,37120,14.4,26575,11624,13418,13.4,4.8,28.8
1986,District of Columbia,2.5,27713,381871,17574,2148,12.9,983,1643,9.8,980,38187,65900,17.3,7295,38967,56541,14.8,9359,14629,16930,7.3,4.6,29.6
1986,Florida,5,378888,3787502,259818,47591,17.9,23310,34112,12.8,23278,486324,865212,22.8,147051,413772,673590,17.8,191622,225869,271892,10,6.9,35.6
1986,Geogia,5.2,170234,2152526,126102,19719,16.2,8764,13765,11.3,8758,262060,432294,20.1,56258,195489,321591,14.9,110703,100749,124204,7.9,5.9,29.8
1986,Hawaii,6.2,26290,331213,16007,3021,13.3,1500,2311,10.2,1500,40342,66632,20.1,7798,29907,45914,13.9,20718,18958,23003,7.9,4.8,27.8
1986,Idaho,2.2,17495,252742,13408,2856,13.6,1560,2418,11.5,1555,28038,45533,18,8338,26561,39969,15.8,5564,18051,21219,6.9,5.3,31.6
1986,Illinois,2.9,271223,4152086,211964,27683,12.5,14169,22205,10,14131,429619,700842,16.9,98903,368962,580926,14,119916,188829,223773,6.5,5.1,28
1986,Indiana,3.5,122581,1844133,85854,13502,12.9,6886,10408,10,6855,182789,305370,16.6,45431,155498,241352,13.1,64018,86853,105751,6.6,4.7,26.2
1986,Iowa,2,56260,857244,44855,6866,10.7,4626,6962,10.9,4626,82260,138520,16.2,24197,76669,121524,14.2,16996,53517,63999,6.6,5.2,28.4
1986,Kansas,2.1,59344,796104,48099,7318,12.7,4753,6866,12,4727,81132,140476,17.6,24706,75434,123533,15.5,16943,48881,57567,7.5,6,31
1986,Kentucky,4.1,71683,1057476,49447,8494,13.1,4731,6839,10.5,4717,109128,180811,17.1,27903,87790,137237,13,43574,55355,65776,6.8,4.7,26
1986,Louisiana,-1.8,96930,1233080,83610,11060,13.3,7542,10891,13.1,7528,124875,221805,18,45764,160330,243940,19.8,-22135,69072,83237,7.9,6.8,36
1986,Maine,4.7,25179,356264,19178,4015,15.6,1726,2640,10.3,1709,39923,65102,18.3,9632,29274,48452,13.6,16650,23017,26308,7.1,5.4,27.2
1986,Maryland,5.6,127820,1523191,83779,13117,15.5,5320,8401,9.9,5197,188892,316712,20.8,38822,148104,231883,15.2,84829,72479,87147,8.4,5.5,30.4
1986,Massachusetts,2.8,181683,2641146,142391,17767,13.7,8108,12637,9.8,8085,294163,475846,18,67383,259314,401705,15.2,74141,112759,131643,6.9,5.4,30.4
1986,Michigan,5.7,203717,3003004,140287,21763,13.2,11304,17202,10.4,11282,346884,550601,18.3,71744,236673,376960,12.6,173641,138451,167450,6.8,4.7,25.2
1986,Minnesota,2.3,103362,1602486,91613,11606,12.9,6221,9804,10.9,6194,180510,283872,17.7,47610,154493,246106,15.4,37766,76442,90673,6.5,5.7,30.8
1986,Mississippi,4.3,46289,672467,36656,6083,13.5,3287,4997,11.1,3274,83052,129341,19.2,19813,63404,100060,14.9,29281,38325,45637,6.9,5.5,29.8
1986,Missouri,4,131510,1800448,93536,14609,13.9,6104,10330,9.8,6064,197214,328724,18.3,42371,164171,257707,14.3,71017,89489,107047,7.3,5.2,28.6
1986,Montana,-1.1,15503,216491,14722,2969,13.7,1922,2817,13,1920,20232,35735,16.5,9412,23360,38082,17.6,-2347,19052,21621,7.2,6.8,33
1986,Nebraska,1.4,35585,514435,25002,4143,10.9,2585,3982,10.5,2578,45776,81361,15.8,13579,48912,73914,14.4,7447,32836,38099,6.9,4.9,28.8
1986,Nevada,4.9,34843,385468,28565,3665,17.6,1918,2889,13.9,1917,46701,81544,21.2,14199,34285,62850,16.3,18694,18216,21170,9,7.4,32.6
1986,New Hampshire,5.2,37930,422210,28202,4736,18.7,1792,2648,10.5,1790,49968,87898,20.8,12060,37453,65655,15.6,22243,23372,26275,9,6.7,31.2
1986,New Jersey,2.9,214193,2944309,160379,23678,14.1,11516,17618,10.5,11489,339494,553687,18.8,70144,309238,469617,15.9,84070,150356,171239,7.3,5.4,31.8
1986,New Mexico,1.8,35717,383272,23117,4741,16.1,2406,3714,12.6,2403,41346,77063,20.1,13860,46958,70075,18.3,6988,25598,29909,9.3,6,36.6
1986,New York,2.9,415196,6499881,342601,50293,13.2,28407,41451,10.9,28325,714853,1130049,17.4,162731,599361,941962,14.5,188087,340644,385808,6.4,5.3,29
1986,North Carolina,4.9,170998,2300094,108580,18767,14.7,8573,12976,10.2,8481,248008,419006,18.2,53039,196599,305179,13.3,113827,106573,129909,7.4,4.7,26.6
1986,North Dakota,-0.5,11605,189562,9665,1876,11.1,1169,1772,10.5,1166,16396,28001,14.8,5941,19385,29050,15.3,-1049,14663,16882,6.1,5.1,29.6
1986,Ohio,2.6,230213,3727732,192791,24868,12.2,12651,19914,9.8,12613,384445,614658,16.5,108633,326593,519384,13.9,95274,164812,205807,6.2,5.2,27.8
1986,Oklahoma,-1.9,73128,944842,68345,9345,13.6,6921,9841,14.3,6903,89397,162525,17.2,37329,112021,180366,19.1,-17841,57575,68284,7.7,7.2,34.4
1986,Oregon,2.9,66569,844527,53650,9833,15.4,5230,7798,12.2,5225,93285,159854,18.9,30161,81606,135256,16,24598,55462,64798,7.9,6.4,32
1986,Pennsylvania,3,276212,4076649,196904,29142,12.9,13456,21221,9.4,13423,413120,689332,16.9,99275,367870,564774,13.9,124558,189315,228738,6.8,4.8,27.8
1986,Rhode Island,5.4,24409,369651,17355,3067,14,1439,2141,9.8,1435,40356,64765,17.5,10578,27272,44627,12.1,20138,20131,22348,6.6,4.7,24.2
1986,South Carolina,2.6,75649,1044552,59137,9136,14.7,4253,6574,10.6,4250,113852,189501,18.1,26641,102460,161597,15.5,27904,52164,63180,7.2,5.7,31
1986,South Dakota,0.3,12482,193007,10640,1937,11.5,1116,1766,10.5,1115,17340,29822,15.5,6723,18745,29385,15.2,437,14950,16954,6.5,5.5,30.4
1986,Tennessee,4.4,115740,1603062,87650,13070,14.4,6703,10013,11.1,6690,183370,299110,18.7,47135,142084,229734,14.3,69376,75788,91817,7.2,5.5,28.6
1986,Texas,0,472714,5561133,400440,52914,15.3,31199,46156,13.4,31056,618866,1091580,19.6,211728,688319,1088759,19.6,2821,277741,348259,8.5,7.2,39.2
1986,Utah,2.7,43612,481290,31290,4564,15.3,2560,3935,13.2,2551,54473,98085,20.4,17844,53784,85074,17.7,13011,25259,30150,9.1,6.5,35.4
1986,Vermont,5.9,13940,194338,9353,2338,15.7,1120,1623,10.9,1120,21445,35385,18.2,5725,14524,23877,12.3,11508,13768,15239,7.2,4.8,24.6
1986,Virginia,7.2,158225,1916697,89441,17105,15.3,7077,11114,10,7062,229204,387429,20.2,42478,158845,248286,13,139143,93021,114574,8.3,4.7,26
1986,Washington,4.3,111590,1380402,89738,15705,15.8,7853,12161,12.2,7811,178770,290360,21,47218,140431,230169,16.7,60191,85622,100918,8.1,6.5,33.4
1986,West Virginia,0.9,37048,446056,33296,3996,12.5,2308,3654,11.4,2302,42092,79140,17.7,12429,41712,75008,16.8,4132,27209,32207,8.3,7.5,33.6
1986,Wisconsin,0.4,91476,1599541,109118,10425,10.8,6949,12873,13.3,6914,153046,244522,15.3,42178,129004,238122,14.9,6400,80616,95092,5.7,6.8,29.8
1986,Wyoming,-2.2,10978,133664,10454,1668,12.7,1240,1844,14,1239,13955,24933,18.7,6534,17477,27931,20.9,-2998,11366,13021,8.2,7.8,37.4
1987,Alabama,1.2,85721,1200238,72345,11313,15.6,5603,8636,11.9,5560,130889,216610,18,33710,129048,201393,16.8,15217,60258,73813,7.1,6,33.6
1987,Alaska,-7,12933,145006,16103,2014,16.9,1467,2281,19.2,1453,16079,29012,20,9133,23028,39131,27,-10119,9909,11684,8.9,11.1,40
1987,Arizona,1.7,115527,1123696,97931,13545,19.4,6243,9662,13.8,6185,129757,245284,21.8,45399,127604,225535,20.1,19749,58318,71502,10.3,8.7,40.2
1987,Arkansas,1,46580,699345,46595,6842,14.9,3977,5660,12.3,3946,73758,120338,17.2,26184,66988,113583,16.2,6755,39898,46468,6.7,6.7,32.4
1987,California,2.9,845682,9883744,787625,101130,17.1,47572,74324,12.6,47020,1294653,2140335,21.7,364454,1070030,1857655,18.8,282680,498637,601790,8.6,8,37.6
1987,Colorado,-3.7,110481,1179240,119082,13875,17,8086,12495,15.3,7987,119000,229481,19.5,57649,154588,273670,23.2,-44189,68775,81912,9.4,10.1,39
1987,Connecticut,4.1,92247,1459992,73950,11757,15.3,5306,7985,10.4,5283,161076,253323,17.4,36699,120289,194239,13.3,59084,68351,78649,6.3,5.1,26.6
1987,Delaware,-1.1,16706,272279,14583,2247,16.3,930,1478,10.7,928,35536,52242,19.2,5413,40657,55240,20.3,-2998,12152,14145,6.1,5.4,38.4
1987,District of Columbia,4.3,24162,399585,20405,2205,12.9,1075,1898,11.1,1065,45559,69721,17.4,8846,32095,52500,13.1,17221,14828,17220,6,5.1,26.2
1987,Florida,3.4,416100,3985126,320415,53022,19,25981,37431,13.4,25796,480635,896735,22.5,175329,441126,761541,19.1,135194,235617,286073,10.4,8,38.2
1987,Geogia,2.9,202803,2265027,152591,21394,16.8,9794,15351,12.1,9720,257257,460060,20.3,67453,240674,393265,17.4,66795,104235,129764,9,6.7,34.8
1987,Hawaii,4.8,30077,353282,24867,3522,15,1632,2593,11.1,1621,46264,76341,21.6,11021,34547,59414,16.8,16927,19499,23814,8.5,7,33.6
1987,Idaho,-0.6,20310,254619,20011,3168,14.8,1548,2637,12.3,1535,27258,47568,18.7,10497,29061,49072,19.3,-1504,18375,21600,8,7.9,37.4
1987,Illinois,-0.2,265263,4232605,274757,30933,13.7,15476,24886,11,15370,421816,687079,16.2,104806,418615,693372,16.4,-6293,192023,228983,6.3,6.5,32.4
1987,Indiana,3.9,127028,1923141,110968,14915,13.9,7375,11508,10.7,7325,226917,353945,18.4,50562,168453,279421,14.5,74524,88834,108810,6.6,5.8,29
1987,Iowa,1.4,58643,879780,51190,7803,12.1,4539,7176,11.2,4486,85579,144222,16.4,24971,80659,131849,15,12373,53491,64363,6.7,5.8,30
1987,Kansas,-3.2,59363,798343,83039,7698,13.3,4691,7132,12.3,4639,76428,135791,17,27901,78021,161060,20.2,-25269,48907,57884,7.4,10.4,34
1987,Kentucky,2.1,71549,1101927,67496,9376,14.1,4853,7611,11.4,4840,114455,186004,16.9,30040,95644,163140,14.8,22864,56376,67318,6.5,6.1,29.6
1987,Louisiana,-5.6,90650,1193986,108828,10617,12.9,8193,12637,15.4,8110,114132,204782,17.2,52757,163589,272417,22.8,-67635,66411,80651,7.6,9.1,34.4
1987,Maine,6.4,31734,380019,22532,4820,17.7,1918,2921,10.7,1912,43915,75649,19.9,10720,28680,51212,13.5,24437,24466,28132,8.4,5.9,27
1987,Maryland,5.7,159196,1624802,94454,14470,16.2,6170,9703,10.8,6105,189855,349051,21.5,44401,161990,256444,15.8,92607,75607,91745,9.8,5.8,31.6
1987,Massachusetts,1.4,176577,2715234,161309,19834,14.8,9171,13913,10.3,9122,297398,473975,17.5,71481,274836,436145,16.1,37830,116844,137046,6.5,5.9,32.2
1987,Michigan,1.9,204900,3147301,171999,24903,14.6,11791,18161,10.6,11694,330709,535609,17,76827,304442,476441,15.1,59168,142587,173534,6.5,5.5,30.2
1987,Minnesota,1.8,110229,1652382,113151,12695,13.8,6335,10134,11,6287,178600,288829,17.5,62679,147091,260242,15.7,28587,77712,92833,6.7,6.8,31.4
1987,Mississippi,-0.5,47639,692385,42987,6560,14.3,3746,5563,12.1,3713,69687,117326,16.9,23234,77357,120344,17.4,-3018,38752,46339,6.9,6.2,33.8
1987,Missouri,2.3,137609,1870316,119876,16482,15.1,8145,12576,11.5,8070,206735,344344,18.4,54232,181053,300929,16.1,43415,91762,110633,7.4,6.4,32.2
1987,Montana,1,17277,217775,15777,3186,14.7,1893,2933,13.5,1877,23972,41249,18.9,8804,23245,39022,17.9,2227,19005,21722,7.9,7.2,35.8
1987,Nebraska,1.7,32348,527217,33124,4629,12.1,2552,3928,10.2,2524,54869,87217,16.5,14757,44978,78102,14.8,9115,33068,38628,6.1,6.3,29.6
1987,Nevada,8.7,41927,415841,26805,4226,19.4,1893,2976,13.7,1873,60590,102517,24.7,14675,39602,66407,16,36110,19135,22309,10.1,6.4,32
1987,New Hampshire,4,36549,444310,27611,5401,19.7,2037,3030,11,2032,52463,89012,20,14418,43322,70933,16,18079,25249,28557,8.2,6.2,32
1987,New Jersey,3.4,253114,3053041,198113,26411,15.1,12555,18969,10.9,12492,368032,621146,20.3,86591,319027,517140,16.9,104006,155668,178070,8.3,6.5,33.8
1987,New Mexico,1.2,36907,393305,29618,4754,15.7,2622,3987,13.2,2608,43929,80836,20.6,16473,46870,76488,19.4,4348,25937,30459,9.4,7.5,38.8
1987,New York,1.7,396993,6760940,382309,54495,14,31100,44355,11.4,30975,750947,1147940,17,201760,654669,1036978,15.3,110962,346612,394396,5.9,5.7,30.6
1987,North Carolina,1.5,161377,2388193,140901,20694,15.6,9304,14436,10.9,9271,257227,418604,17.5,61799,241608,382509,16,36095,109913,135644,6.8,5.9,32
1987,North Dakota,1.1,12851,190797,10838,2119,12.5,1204,1871,11,1195,17520,30371,15.9,6034,17380,28218,14.8,2153,14755,17058,6.7,5.7,29.6
1987,Ohio,1.9,253154,3834228,239028,28393,13.6,13196,21448,10.3,13069,411631,664785,17.3,94165,350739,589767,15.4,75018,168401,211958,6.6,6.2,30.8
1987,Oklahoma,-4.6,72602,925714,78028,9301,13.7,6799,10158,15,6722,81332,153934,16.6,40496,117918,195946,21.2,-42012,55905,66914,7.8,8.4,33.2
1987,Oregon,3.5,72283,876897,62050,10977,16.7,5650,8551,13,5621,103177,175460,20,34866,82222,144272,16.5,31188,56822,66905,8.2,7.1,33
1987,Pennsylvania,2.1,268721,4211900,243157,31900,13.7,14768,23240,10,14650,441770,710491,16.9,107955,381901,625058,14.8,85433,194697,236702,6.4,5.8,29.6
1987,Rhode Island,3.8,24483,388723,20445,3504,15.3,1650,2390,10.5,1637,43151,67634,17.4,10956,32441,52886,13.6,14748,20985,23374,6.3,5.3,27.2
1987,South Carolina,4.2,83460,1089692,64762,10323,16,4688,7369,11.4,4649,127843,211303,19.4,30471,101304,166066,15.2,45237,53782,65831,7.7,5.9,30.4
1987,South Dakota,2.1,13100,198232,11308,2220,13,1209,1938,11.3,1202,18938,32038,16.2,6409,16703,28011,14.1,4027,15111,17196,6.6,5.7,28.2
1987,Tennessee,2.5,118339,1672313,110977,14691,15.7,7129,10644,11.4,7096,191234,309573,18.5,49284,156359,267336,16,42237,78066,95419,7.1,6.6,32
1987,Texas,-4.2,466491,5478753,503652,53577,15.4,34860,53079,15.3,34454,547355,1013846,18.5,237080,741502,1245154,22.7,-231308,273401,346457,8.5,9.2,37
1987,Utah,1.2,38705,496982,37675,5009,16.4,2566,4136,13.5,2522,58526,97231,19.6,17771,53781,91456,18.4,5775,25704,30862,7.8,7.6,36.8
1987,Vermont,6.2,17618,207870,11434,2656,16.9,1134,1583,10.1,1121,22445,40063,19.3,6760,15807,27241,13.1,12822,14606,16245,8.5,5.5,26.2
1987,Virginia,4.6,173310,2036958,127025,19610,16.6,8285,12893,10.9,8210,238372,411682,20.2,53752,191232,318257,15.6,93425,96918,120928,8.5,6.2,31.2
1987,Washington,4.5,125179,1423705,98808,17335,16.9,8438,13066,12.7,8351,179982,305161,21.4,53066,141492,240300,16.9,64861,88044,104592,8.8,6.9,33.8
1987,West Virginia,0.8,32401,452255,28164,4621,14.2,2415,3678,11.3,2402,42953,75354,16.7,14349,43916,72080,15.9,3274,27543,32931,7.2,6.2,31.8
1987,Wisconsin,5.7,120228,1672542,60276,14396,14.5,1920,7186,7.3,1857,165742,285970,17.1,17586,130780,191056,11.4,94914,86963,103021,7.2,3.6,22.8
1987,Wyoming,-9,8937,127412,12294,1673,13,1196,1930,15,1188,10553,19490,15.3,6212,18637,30931,24.3,-11441,11030,12660,7,9.6,30.6
1988,Alabama,2.8,93070,1208299,73633,9836,13.3,5836,8891,12.1,5836,129015,222085,18.4,33259,115247,188880,15.6,33205,60133,74074,7.7,6.1,31.2
1988,Alaska,-2.5,12815,133238,15402,1814,15.7,1148,1861,16.1,1148,17375,30190,22.7,6412,18157,33559,25.2,-3369,9722,11502,9.6,11.6,45.4
1988,Arizona,4.5,116438,1141813,87104,11908,16.5,6765,10152,14.1,6765,148530,264968,23.2,44302,126977,214081,18.7,50887,58831,72792,10.2,7.6,37.4
1988,Arkansas,2.6,46066,676843,41046,5764,12.6,3915,5683,12.4,3915,74680,120746,17.8,19632,61819,102865,15.2,17881,38802,45640,6.8,6.1,30.4
1988,California,4.2,822891,10149718,686503,89631,14.8,49545,75767,12.5,49544,1405242,2228133,22,319211,1117673,1804176,17.8,423957,505005,612513,8.1,6.8,35.6
1988,Colorado,0.9,92574,1156028,92882,12191,14.9,8319,12132,14.9,8319,133862,226436,19.6,45630,123436,216318,18.7,10118,67973,81494,8,8,37.4
1988,Connecticut,1.6,106749,1482419,95901,11063,13.9,5704,8430,10.6,5704,155394,262143,17.7,38946,142399,238300,16.1,23843,70038,80886,7.2,6.5,32.2
1988,Delaware,5.7,20849,278434,15907,1965,13.8,982,1660,11.6,982,34482,55331,19.9,6084,23717,39624,14.2,15707,12312,14401,7.5,5.7,28.4
1988,District of Columbia,0.1,22092,412673,20728,2131,12.3,1124,1887,10.9,1124,48057,70149,17,10419,49203,69931,16.9,218,14784,17420,5.4,5,33.8
1988,Florida,4.5,388618,4128970,305940,48708,16.8,28181,39613,13.7,28179,530071,918689,22.2,165880,424069,730009,17.7,188680,240864,294111,9.4,7.4,35.4
1988,Geogia,4.8,203681,2334375,147951,19487,14.9,10464,15821,12.1,10461,286812,490493,21,65213,229807,377758,16.2,112735,105905,132685,8.7,6.3,32.4
1988,Hawaii,4.9,25953,372821,20664,3087,12.8,1688,2558,10.6,1688,45175,71128,19.1,8967,32299,52963,14.2,18165,19794,24301,7,5.5,28.4
1988,Idaho,4.3,21446,254539,16852,2746,12.8,1725,2564,12,1725,30491,51937,20.4,9259,24162,41014,16.1,10923,18123,21455,8.4,6.6,32.2
1988,Illinois,4.4,280592,4241579,218314,28147,12.3,15499,23732,10.3,15499,487064,767656,18.1,95916,362037,580351,13.7,187305,192616,231231,6.6,5.1,27.4
1988,Indiana,2.9,122440,1950551,114288,12975,11.9,7420,11344,10.4,7420,211912,334352,17.1,62030,162839,277127,14.2,57225,89111,109639,6.3,5.9,28.4
1988,Iowa,5.8,52194,893896,44142,6597,10.3,4301,6565,10.3,4300,106545,158739,17.8,20523,63071,107213,12,51526,52712,63826,5.8,4.9,24
1988,Kansas,2.9,58012,787135,46324,6994,12.1,4328,6377,11,4328,82026,140038,17.8,24363,71163,117487,14.9,22551,48576,58039,7.4,5.9,29.8
1988,Kentucky,4.4,77680,1070294,59990,8637,12.9,5323,7582,11.3,5323,120944,198624,18.6,30685,92132,152122,14.2,46502,56081,67582,7.3,5.6,28.4
1988,Louisiana,1.9,84223,1157912,81808,9615,12.1,7153,10602,13.3,7153,136862,221085,19.1,40798,117066,198874,17.2,22211,64474,79045,7.3,7.1,34.4
1988,Maine,6.7,26867,399702,19332,4249,14.9,2191,3185,11.2,2191,52902,79769,20,10580,33769,53101,13.3,26668,25145,28904,6.7,4.8,26.6
1988,Maryland,3.6,135241,1697971,97172,13530,14.5,6595,10254,11,6595,211042,346283,20.4,47169,187777,284949,16.8,61334,77607,94737,8,5.7,33.6
1988,Massachusetts,2.6,177471,2774318,152920,17905,12.9,9538,14404,10.4,9538,319298,496769,17.9,73354,270757,423677,15.3,73092,119327,140083,6.4,5.5,30.6
1988,Michigan,1.6,208433,3185315,171871,21535,12.3,12055,18880,10.8,12055,328796,537229,16.9,70380,317037,488908,15.3,48321,143989,175707,6.5,5.4,30.6
1988,Minnesota,3.8,105018,1678821,92615,11332,12.2,6375,10005,10.8,6375,203385,308403,18.4,43109,152028,244643,14.6,63760,77716,93508,6.3,5.5,29.2
1988,Mississippi,3.4,47411,670222,37431,5580,12.1,3897,5642,12.3,3896,71422,118833,17.7,19049,58733,96164,14.3,22669,38013,45843,7.1,5.6,28.6
1988,Missouri,0.7,124591,1854926,136131,14218,12.9,8419,12813,11.6,8419,200290,324881,17.5,46165,175153,311284,16.8,13597,91198,110815,6.7,7.3,33.6
1988,Montana,-1,14647,198085,16564,2677,12.6,1863,2868,13.5,1863,21620,36267,18.3,8789,21580,38144,19.3,-1877,18279,21065,7.4,8.4,36.6
1988,Nebraska,4.9,35151,522236,28936,4190,11,2535,3867,10.2,2535,60676,95827,18.3,12417,41112,70048,13.4,25779,32283,38082,6.7,5.5,26.8
1988,Nevada,6.2,41415,445287,35641,3865,17,2012,3002,13.2,2012,67933,109348,24.6,14137,46294,81935,18.4,27413,19608,23086,9.3,8,36.8
1988,New Hampshire,4.6,37679,439825,25338,4657,16.2,2503,3531,12.2,2503,52062,89741,20.4,13495,44178,69516,15.8,20225,25833,29339,8.6,5.8,31.6
1988,New Jersey,2.7,215975,3112640,166432,24536,13.6,13325,19500,10.8,13325,373149,589124,18.9,70783,337311,503743,16.2,85381,158581,182189,6.9,5.3,32.4
1988,New Mexico,1.5,29824,382932,28320,4192,13.8,2750,4075,13.4,2750,46266,76090,19.9,15907,42095,70415,18.4,5675,25540,30306,7.8,7.4,36.8
1988,New York,1.6,400716,6811429,368502,50752,12.8,31749,45035,11.4,31748,797883,1198599,17.6,171335,724497,1092999,16,105600,348575,398492,5.9,5.4,32
1988,North Carolina,5.1,177742,2443107,123738,18924,13.8,9816,15115,11,9816,275522,453264,18.6,50902,206190,329928,13.5,123336,111672,138754,7.3,5.1,27
1988,North Dakota,3.1,11435,180615,10415,1784,10.7,1141,1802,10.8,1141,19060,30495,16.9,5221,14552,24967,13.8,5528,14344,16650,6.3,5.8,27.6
1988,Ohio,3.6,258245,3939083,194273,25144,11.8,13475,22123,10.4,13474,430917,689162,17.5,76221,353534,547807,13.9,141355,170138,214686,6.6,4.9,27.8
1988,Oklahoma,2,65195,867352,63765,8135,12.4,6193,9274,14.1,6193,101533,166728,19.2,31929,85690,149455,17.2,17273,53602,64831,7.5,7.4,34.4
1988,Oregon,5.2,68200,887575,58644,9538,14.3,5723,8447,12.6,5723,117373,185573,20.9,29244,81133,139777,15.7,45796,56728,67301,7.7,6.6,31.4
1988,Pennsylvania,2.7,262643,4298059,232102,28607,12,15467,23971,10.1,15464,468062,730705,17,106051,380802,612904,14.3,117801,197264,240412,6.1,5.4,28.6
1988,Rhode Island,1.7,23170,397924,23556,3173,13.5,1766,2663,11.3,1766,45026,68196,17.1,9857,37837,61393,15.4,6803,21357,23771,5.8,5.9,30.8
1988,South Carolina,6.5,102549,1121053,61085,9438,14.2,5129,7770,11.7,5129,126500,229049,20.4,27206,94565,155650,13.9,73399,54527,67141,9.1,5.4,27.8
1988,South Dakota,3.7,12910,190724,10800,1976,11.6,1202,1862,10.9,1202,19808,32718,17.2,5517,14881,25681,13.5,7037,14953,17063,6.8,5.7,27
1988,Tennessee,4.7,152148,1702024,107517,13377,14,7400,11071,11.5,7400,193921,346069,20.3,43981,158589,266106,15.6,79963,78439,96811,8.9,6.3,31.2
1988,Texas,1.5,457121,5365881,425297,47230,13.7,33950,50099,14.6,33950,646101,1103222,20.6,198917,599496,1024793,19.1,78429,266880,341407,8.5,7.9,38.2
1988,Utah,2.8,42591,492490,36742,4516,14.6,2835,4247,13.8,2835,58048,100639,20.4,18732,49720,86462,17.6,14177,25513,30856,8.6,7.5,35.2
1988,Vermont,1.7,14333,204173,12776,2368,14.6,1281,1817,11.2,1281,21302,35635,17.5,6930,19514,32290,15.8,3345,14785,16484,7,6.3,31.6
1988,Virginia,5.1,169562,2105658,119238,17904,14.6,8730,13531,11,8730,249631,419193,19.9,47580,192681,311919,14.8,107274,99471,124670,8.1,5.7,29.6
1988,Washington,5.4,113996,1461310,97694,15493,14.7,8499,13088,12.5,8497,209298,323294,22.1,46219,146393,244087,16.7,79207,88773,105987,7.8,6.7,33.4
1988,West Virginia,2.1,30540,447788,25633,3924,12,2395,3615,11,2395,46795,77335,17.3,12605,42530,68163,15.2,9172,27511,32973,6.8,5.7,30.4
1988,Wisconsin,4.6,104054,1755600,75847,11564,11.2,6663,9948,9.6,6663,190523,294577,16.8,38149,137490,213337,12.2,81240,87621,104247,5.9,4.3,24.4
1988,Wyoming,-0.3,8670,119605,9280,1480,11.8,1060,1645,13.2,1060,13368,22038,18.4,4752,13048,22328,18.7,-290,10765,12384,7.2,7.8,36.8
1989,Alabama,4.7,91168,1259370,61080,10009,13.3,5685,8158,10.9,5660,141841,233009,18.5,34928,112241,173321,13.8,59688,61306,76014,7.2,4.9,27.6
1989,Alaska,4,16160,134618,17746,1495,13.7,887,2619,23.9,884,19749,35909,26.7,4217,12849,30595,22.7,5314,8518,10384,12,13.2,45.4
1989,Arizona,3.1,108617,1187751,89535,11479,15.7,6862,10299,14,6826,147788,256405,21.6,52184,130100,219635,18.5,36770,59371,73858,9.1,7.5,37
1989,Arkansas,4.5,53331,702968,39392,5746,12.5,3622,5050,11,3561,75051,128382,18.3,25409,57861,97253,13.8,31129,39202,46467,7.6,5.6,27.6
1989,California,3,823088,10516224,806222,87685,14.3,49255,90078,14.7,48921,1391488,2214576,21.1,371483,1094656,1900878,18.1,313698,497327,610180,7.8,7.7,36.2
1989,Colorado,3.1,94535,1182445,87671,11280,13.8,7398,11054,13.6,7366,141137,235672,19.9,48658,110635,198306,16.8,37366,67995,81688,8,7.4,33.6
1989,Connecticut,1.6,89312,1500115,79016,10080,12.4,6146,8952,11,6102,157690,247002,16.5,39044,144475,223491,14.9,23511,70819,82079,6,5.3,29.8
1989,Delaware,6,25642,295576,10963,2278,15.4,939,1468,9.9,935,32434,58076,19.6,6322,29233,40196,13.6,17880,12979,15238,8.7,3.7,27.2
1989,District of Columbia,2.2,21286,405978,21575,2055,11.7,1099,1844,10.5,1097,47129,68415,16.9,10076,37985,59560,14.7,8855,14740,17671,5.2,5.3,29.4
1989,Florida,4.6,381828,4340752,292733,46039,15.5,26943,38421,12.9,26774,555365,937193,21.6,173642,443595,736328,17,200865,246158,301917,8.8,6.7,34
1989,Geogia,2.6,204011,2432773,148101,18807,14,10446,15789,11.8,10394,287623,491634,20.2,77006,278996,427097,17.6,64537,107578,135772,8.4,6.1,35.2
1989,Hawaii,5.6,28842,393082,19410,2970,12.1,1614,2428,9.9,1614,43726,72568,18.5,10181,31121,50531,12.9,22037,20055,24868,7.3,4.9,25.8
1989,Idaho,8.1,23715,271892,15661,2836,13.1,1596,2469,11.4,1574,35329,59044,21.7,9385,21345,37006,13.6,22038,18394,21842,8.7,5.8,27.2
1989,Illinois,3.4,291149,4413452,209215,27828,11.9,15424,23572,10.1,15220,462224,753373,17.1,109927,396453,605668,13.7,147705,195191,235604,6.6,4.7,27.4
1989,Indiana,4.9,123044,2037085,93597,13116,11.8,7242,10645,9.6,7194,224480,347524,17.1,53326,155674,249271,12.2,98253,90618,112236,6,4.6,24.4
1989,Iowa,6.2,67668,947453,42751,6643,10.3,3999,5850,9.1,3994,99762,167430,17.7,22412,66570,109321,11.5,58109,53217,64661,7.1,4.5,23
1989,Kansas,6.3,80481,824926,44156,6609,11.4,4407,6329,10.9,4383,85671,166152,20.1,26349,69930,114086,13.8,52066,48577,58350,9.8,5.4,27.6
1989,Kentucky,4,74254,1115697,58276,8303,12.2,4920,7008,10.3,4895,122472,196726,17.6,31698,93017,151293,13.6,45433,56900,68895,6.7,5.2,27.2
1989,Louisiana,2.8,82528,1186687,74312,8641,11,6229,9323,11.8,6186,141364,223892,18.9,42411,116729,191041,16.1,32851,63629,78520,7,6.3,32.2
1989,Maine,3.3,28191,420289,23589,4177,14.2,2308,3279,11.2,2274,48851,77042,18.3,14345,39654,63243,15,13799,25805,29875,6.7,5.6,30
1989,Maryland,2.1,124332,1749401,93126,13061,13.6,6498,9983,10.4,6471,192933,317265,18.1,46466,186732,279858,16,37407,79783,97856,7.1,5.3,32
1989,Massachusetts,1.5,169011,2836688,140849,16701,11.8,10370,14844,10.5,10198,311186,480197,16.9,76971,295245,436094,15.4,44103,120312,142397,6,5,30.8
1989,Michigan,3.7,191563,3272939,144469,21646,12.2,11675,17318,9.7,11608,363703,555266,17,80289,291221,435690,13.3,119576,146920,180311,5.9,4.4,26.6
1989,Minnesota,3.4,108311,1740605,92919,11414,12.1,6011,9196,9.7,5974,183985,292296,16.8,43493,139752,232671,13.4,59625,79180,95704,6.2,5.3,26.8
1989,Mississippi,2.6,45903,695980,39840,5583,12.1,3546,5062,11,3514,72162,118065,17,22423,60361,100201,14.4,17864,38176,46432,6.6,5.7,28.8
1989,Missouri,3.8,120108,1900552,95615,14291,12.8,7996,11751,10.5,7935,220378,340486,17.9,53542,171597,267212,14.1,73274,92882,113353,6.3,5,28.2
1989,Montana,5.1,16129,202220,11903,2701,12.8,1641,2460,11.6,1639,23741,39870,19.7,7672,17521,29424,14.6,10446,18447,21256,8,5.9,29.2
1989,Nebraska,4.2,34249,546735,27488,4293,11.2,2535,3776,9.9,2525,59152,93401,17.1,15480,42793,70281,12.9,23120,32512,38574,6.3,5,25.8
1989,Nevada,7.7,40897,478236,33534,4142,17.5,1868,2856,12,1860,75467,116364,24.3,17097,46080,79614,16.6,36750,20656,24365,8.6,7,33.2
1989,New Hampshire,1.7,34409,455591,26212,4078,13.8,2741,3707,12.6,2715,44936,79345,17.4,17045,45370,71582,15.7,7763,25964,29721,7.6,5.8,31.4
1989,New Jersey,1.5,209294,3186478,170248,22984,12.5,13748,20522,11.2,13692,362351,571645,17.9,89068,353786,524034,16.4,47611,159955,184810,6.6,5.3,32.8
1989,New Mexico,2.1,30448,389990,25475,4225,13.9,2586,3853,12.6,2568,44998,75446,19.3,15550,41715,67190,17.2,8256,25766,30708,7.8,6.5,34.4
1989,New York,1.8,411152,6922355,351403,50602,12.6,31762,45366,11.3,31578,738375,1149527,16.6,195782,673236,1024639,14.8,124888,351755,404333,5.9,5.1,29.6
1989,North Carolina,2.8,169917,2557204,119777,18299,13,9524,14564,10.4,9466,266740,436657,17.1,58887,244833,364610,14.3,72047,114402,142586,6.6,4.7,28.6
1989,North Dakota,2.6,11733,184980,9356,1673,10,1072,1554,9.3,1069,17256,28989,15.7,5263,14872,24228,13.1,4761,14374,16777,6.3,5.1,26.2
1989,Ohio,3.4,266428,4096283,206482,24718,11.4,13439,20521,9.5,13319,433185,699613,17.1,92377,352719,559201,13.7,140412,172489,219033,6.5,5,27.4
1989,Oklahoma,2.9,62305,891090,58735,8224,12.6,5468,7926,12.2,5432,102391,164696,18.5,34900,80076,138811,15.6,25885,53837,65207,7,6.6,31.2
1989,Oregon,1.4,67689,919420,112226,8202,12.7,5178,13447,20.8,5143,132905,200594,21.8,31825,75352,187578,20.4,13016,51213,62002,7.4,12.2,40.8
1989,Pennsylvania,2.9,260079,4409414,213035,28179,11.6,15157,22807,9.4,14985,453036,713115,16.2,105869,372676,585711,13.3,127404,201138,245949,5.9,4.8,26.6
1989,Rhode Island,0.7,28036,404615,22655,3142,13.1,1919,2637,11,1892,38662,66698,16.5,14484,41264,63919,15.8,2779,21791,24360,6.9,5.6,31.6
1989,South Carolina,3.3,81280,1182060,67168,8894,13.1,4872,7258,10.7,4855,128057,209337,17.7,36461,102900,170068,14.4,39269,55592,68817,6.9,5.7,28.8
1989,South Dakota,4.4,11312,198652,9745,1898,11,1116,1587,9.2,1116,22767,34079,17.2,5681,15602,25347,12.8,8732,15131,17346,5.7,4.9,25.6
1989,Tennessee,4.3,128938,1789321,97299,12914,13.2,7341,10607,10.8,7197,208621,337559,18.9,56822,164726,262025,14.6,75534,79653,99307,7.2,5.4,29.2
1989,Texas,3.2,438091,5508593,408980,44527,13.1,30014,45313,13.3,29642,701821,1139912,20.7,226498,554776,963756,17.5,176156,265421,340887,8,7.4,35
1989,Utah,6.5,46586,520388,34177,4173,13.5,2658,3979,12.9,2576,70045,116631,22.4,19902,48807,82984,15.9,33647,25495,31047,9,6.6,31.8
1989,Vermont,5,14816,212300,10551,2444,14.6,1390,1861,11.1,1365,22146,36962,17.4,7117,15765,26316,12.4,10646,15271,17094,7,5,24.8
1989,Virginia,4.2,165216,2211800,110277,17512,13.8,8901,13557,10.7,8821,243625,408841,18.5,56501,206672,316949,14.3,91892,101909,128755,7.5,5,28.6
1989,Washington,3.5,113917,1530599,202429,12963,13,8170,25690,25.8,8112,272000,385917,25.2,54996,129122,331551,21.7,54366,75543,93124,7.4,13.2,43.4
1989,West Virginia,2.9,33362,461621,23423,3795,11.4,2330,3398,10.2,2318,44048,77410,16.8,13893,40784,64207,13.9,13203,27714,33385,7.2,5.1,27.8
1989,Wisconsin,4,94640,1834614,82812,11772,11.2,6573,9823,9.3,6536,201779,296419,16.2,44682,141592,224404,12.2,72015,88782,106209,5.2,4.5,24.4
1989,Wyoming,3.4,8405,121576,7196,1423,11.5,937,1428,11.5,932,14697,23102,19,4581,11818,19014,15.6,4088,10698,12358,6.9,5.9,31.2
1990,Alabama,3.3,72790,1308045,59017,9446,12.3,5556,7845,10.2,5512,144530,217320,16.6,35188,114913,173930,13.3,43390,62128,77158,5.6,4.5,26.6
1990,Alaska,14.4,22297,143520,7288,2828,25.2,649,1072,9.5,648,20866,43163,30.1,4045,15247,22535,15.7,20628,10157,12097,15.5,5.1,31.4
1990,Arizona,1.6,94689,1211932,79134,11266,15.1,6416,9402,12.6,6365,143199,237888,19.6,43173,139118,218252,18,19636,60339,75080,7.8,6.5,36
1990,Arkansas,3.6,41301,730873,29107,5776,12.3,3321,4608,9.8,3319,77869,119170,16.3,17988,63456,92563,12.7,26607,39886,47312,5.7,4,25.4
1990,California,4.8,920105,10908220,619747,104509,16.7,45517,67345,10.8,45313,1365773,2285878,21,342700,1146406,1766153,16.2,519725,526427,642827,8.4,5.7,32.4
1990,Colorado,3.2,93101,1220282,79909,11760,14.2,6478,9552,11.6,6444,135958,229059,18.8,45973,110159,190068,15.6,38991,69416,83404,7.6,6.5,31.2
1990,Connecticut,-1.4,74476,1497164,69670,9025,11,6003,8638,10.5,5973,127649,202125,13.5,37713,154075,223745,14.9,-21620,70300,81871,5,4.7,27
1990,Delaware,3,14302,308937,10085,2148,13.8,958,1445,9.3,958,32238,46540,15.1,5745,27348,37433,12.1,9107,13461,15859,4.6,3.3,24.2
1990,District of Columbia,-1.1,18056,408738,17522,1880,10.7,1241,1970,11.2,1237,38782,56838,13.9,7679,43669,61191,15,-4353,14497,17468,4.4,4.3,27.8
1990,Florida,2.8,361686,4485056,284893,46520,15.2,26475,36577,12,26337,521385,883071,19.7,171200,472645,757538,16.9,125533,251806,309518,8.1,6.4,33.8
1990,Geogia,2,161299,2487945,138080,17768,13,10188,15063,11,10128,282379,443678,17.8,69692,255758,393838,15.8,49840,108444,137562,6.5,5.5,31.6
1990,Hawaii,5.6,27805,414778,18469,3227,12.8,1421,2199,8.7,1418,45969,73774,17.8,11112,32101,50570,12.2,23204,20775,25751,6.7,4.5,24.4
1990,Idaho,4.7,18554,288998,13531,3311,14.8,1395,1991,8.9,1388,35973,54527,18.9,8422,27442,40973,14.2,13554,19489,23039,6.4,4.7,28.4
1990,Illinois,2.3,243317,4534140,186785,27028,11.4,14472,21638,9.1,14411,446787,690104,15.2,98184,397922,584707,12.9,105397,198556,239858,5.4,4.1,25.8
1990,Indiana,2.4,108421,2106302,82076,12940,11.4,6951,10020,8.8,6922,204817,313238,14.9,44788,181403,263479,12.5,49759,92188,114595,5.1,3.9,25
1990,Iowa,3.1,46380,991671,34759,6476,9.9,3717,5322,8.2,3704,96150,142530,14.4,21913,77059,111818,11.3,30712,53791,65557,4.7,3.5,22.6
1990,Kansas,3.4,50104,864234,41398,6412,11,4156,6004,10.3,4142,89735,139839,16.2,23465,69576,110974,12.8,28865,48532,58428,5.8,4.8,25.6
1990,Kentucky,3.6,70528,1155358,52338,8451,12.1,4715,6669,9.6,4701,122828,193356,16.7,30148,99129,151467,13.1,41889,57929,70283,6.1,4.5,26.2
1990,Louisiana,4.1,80088,1224466,68473,8939,11.4,5561,8093,10.3,5509,146993,227081,18.5,38258,107675,176148,14.4,50933,63913,78977,6.5,5.6,28.8
1990,Maine,-2.6,23721,420075,21725,3438,11.6,2410,3415,11.5,2405,35170,58891,14,13710,48182,69907,16.6,-11016,25462,29606,5.6,5.2,28
1990,Maryland,2.3,112712,1786035,89879,12822,12.9,6319,9704,9.8,6285,197522,310234,17.4,47001,179418,269297,15.1,40937,81789,100504,6.3,5,30.2
1990,Massachusetts,-4.1,129901,2801266,145067,14558,10.3,10908,15630,11.1,10847,229965,359866,12.8,80959,327396,472463,16.9,-112597,117524,140130,4.6,5.2,25.6
1990,Michigan,1.2,183946,3352229,140614,20782,11.4,11365,16673,9.2,11303,323881,507827,15.1,73224,324201,464815,13.9,43012,149076,183471,5.5,4.2,27.8
1990,Minnesota,3.1,91717,1795142,80424,11162,11.5,5644,8687,9,5609,193600,285317,15.9,39262,148884,229308,12.8,56009,80981,97753,5.1,4.5,25.6
1990,Mississippi,3.1,39857,714218,33961,5585,12,3428,4830,10.4,3406,76267,116124,16.3,19871,60418,94379,13.2,21745,38524,46867,5.6,4.8,26.4
1990,Missouri,1.8,111852,1952712,85123,13611,11.9,7486,11140,9.8,7453,192917,304769,15.6,45704,183973,269096,13.8,35673,94420,115207,5.7,4.4,27.6
1990,Montana,4.7,13084,213359,11051,2583,12,1383,2072,9.7,1382,25080,38164,17.9,6907,17217,28268,13.2,9896,18796,21649,6.1,5.2,26.4
1990,Nebraska,3.7,29321,568260,21487,4048,10.4,2273,3409,8.8,2272,55999,85320,15,12667,42812,64299,11.3,21021,32829,39007,5.2,3.8,22.6
1990,Nevada,7.9,36633,516403,25914,4281,17.1,1922,2740,10.9,1913,79598,116231,22.5,15904,49244,75158,14.6,41073,21800,25719,7.1,5,29.2
1990,New Hampshire,-4.7,24597,455024,27967,3521,12,2888,3955,13.5,2886,37046,61643,13.5,17445,54626,82593,18.2,-20950,25125,28975,5.4,6.1,27
1990,New Jersey,-0.2,187321,3202458,163199,21494,11.6,13396,19302,10.4,13363,314179,501500,15.7,82249,347395,510594,15.9,-9094,159964,185608,5.8,5.1,31.4
1990,New Mexico,4.3,28895,401338,23112,4138,13.4,2255,3404,11,2243,47798,76693,19.1,13287,36237,59349,14.8,17344,26246,31208,7.2,5.8,29.6
1990,New York,0.3,359067,6982030,332651,46931,11.6,31176,42872,10.6,31041,693090,1052157,15.1,187280,702303,1034954,14.8,17203,351934,405944,5.1,4.8,29.6
1990,North Carolina,3,152507,2628527,125334,18136,12.6,9413,13775,9.5,9366,280179,432686,16.5,68490,228828,354162,13.5,78524,116947,145997,5.8,4.8,27
1990,North Dakota,3.4,8513,190600,7877,1609,9.6,1045,1461,8.7,1044,19249,27762,14.6,4778,13442,21319,11.2,6443,14394,16812,4.5,4.1,22.4
1990,Ohio,1.6,216348,4198647,170517,23686,10.7,13041,19488,8.8,12957,392336,608684,14.5,95646,372633,543150,12.9,65534,174524,222305,5.2,4.1,25.8
1990,Oklahoma,3.9,57372,921164,47688,7968,12.2,4831,7012,10.7,4819,102640,160012,17.4,27956,76718,124406,13.5,35606,54368,65781,6.2,5.2,27
1990,Oregon,8.1,121443,962890,50403,14931,22.6,4159,6194,9.4,4128,107789,229232,23.8,27839,100720,151123,15.7,78109,59146,70345,12.6,5.2,31.4
1990,Pennsylvania,1.8,210718,4516192,178341,26902,10.8,14647,21437,8.6,14589,442405,653123,14.5,97080,396193,574534,12.7,78589,204164,250224,4.7,3.9,25.4
1990,Rhode Island,-3.2,19017,398502,19475,2690,11.1,1883,2604,10.7,1882,32534,51551,12.9,10863,44541,64016,16.1,-12465,21626,24238,4.8,4.9,25.8
1990,South Carolina,3.7,74075,1223846,54731,8805,12.7,4770,6911,9.9,4751,131281,205356,16.8,30049,105059,159790,13.1,45566,56645,70208,6.1,4.5,26.2
1990,South Dakota,5.2,13611,206824,10083,2088,11.9,1081,1542,8.8,1080,22576,36187,17.5,5457,15394,25477,12.3,10710,15488,17756,6.6,4.9,24.6
1990,Tennessee,1.9,107860,1844231,87357,12319,12.3,7063,10252,10.3,7047,187307,295167,16,45448,172805,260162,14.1,35005,80435,100697,5.8,4.7,28.2
1990,Texas,3.7,423327,5693271,368195,46282,13.5,26209,38757,11.3,25945,705177,1128504,19.8,186064,546882,915077,16.1,213427,269514,346290,7.4,6.5,32.2
1990,Utah,5.2,36557,550160,29327,4189,13.3,2171,3226,10.3,2159,69539,106096,19.3,16072,48247,77574,14.1,28522,26102,31757,6.6,5.3,28.2
1990,Vermont,-0.5,11434,215990,11001,2009,11.7,1328,1789,10.4,1326,20141,31575,14.6,6384,21660,32661,15.1,-1086,15309,17187,5.3,5.1,29.2
1990,Virginia,2.5,143467,2283216,106542,17340,13.3,8640,12922,9.9,8585,241439,384906,16.9,53343,222875,329417,14.4,55489,104373,132428,6.3,4.7,28.8
1990,Washington,9.3,239874,1633703,128265,29651,28.7,5746,8909,8.6,5722,206274,446148,27.3,76956,165224,293489,18,152659,94750,113374,14.7,7.9,36
1990,West Virginia,3.1,27703,474967,22680,3837,11.4,2262,3177,9.5,2257,48927,76630,16.1,13957,39262,61942,13,14688,27960,33771,5.8,4.8,26
1990,Wisconsin,3,94143,1897836,71211,11456,10.7,6129,8970,8.4,6099,179205,273348,14.4,38512,145271,216482,11.4,56866,90232,108203,5,3.8,22.8
1990,Wyoming,4.7,7995,126413,7545,1461,11.8,824,1252,10.1,823,16026,24021,19,3949,10583,18128,14.3,5893,10838,12498,6.3,6,28.6
1991,Alabama,0.4,89491,1330914,73332,9724,12.5,5238,8231,10.6,5175,124326,213817,16.1,36661,135468,208800,15.7,5017,62962,78721,6.7,5.5,31.4
1991,Alaska,4.7,12900,156297,8097,1933,15.6,726,1257,10.1,724,21366,34266,21.9,4227,18824,26921,17.2,7345,10628,12744,8.3,5.2,34.4
1991,Arizona,2.1,109364,1234743,80685,11762,15.4,5868,9233,12.1,5808,145021,254385,20.6,45391,147452,228137,18.5,26248,62102,77582,8.9,6.5,37
1991,Arkansas,2.5,53785,753032,34904,6132,12.8,3267,4905,10.2,3244,71253,125038,16.6,20026,71535,106439,14.1,18599,40619,48560,7.1,4.6,28.2
1991,California,-2.3,788570,11037302,715727,92230,14.2,47649,75868,11.7,47126,1167586,1956156,17.7,387619,1488560,2204287,20,-248131,535853,659054,7.1,6.5,35.4
1991,Colorado,2.6,99290,1255925,75714,12798,15,6061,9342,11,5973,136098,235388,18.7,41531,126698,202412,16.1,32976,72125,86888,7.9,6,32.2
1991,Connecticut,-3,85906,1464471,76438,8486,10.4,6078,9420,11.6,6023,118937,204843,14,38537,172321,248759,17,-43916,68844,80861,5.9,5.2,28
1991,Delaware,-0.4,22864,312289,16622,2302,14.2,984,1625,10,970,26098,48962,15.7,5941,33695,50317,16.1,-1355,13870,16554,7.3,5.3,31.4
1991,District of Columbia,-4.7,20022,396999,18283,1987,11.3,983,1914,10.9,966,31566,51588,13,8076,51801,70084,17.7,-18496,14623,17558,5,4.6,26
1991,Florida,-0.6,392545,4537628,317107,48435,15.4,25897,39708,12.7,25550,474120,866665,19.1,179638,574694,891801,19.7,-25136,257912,318238,8.7,7,38.2
1991,Geogia,-2.5,184111,2479409,173620,19158,13.8,9665,15727,11.3,9452,232904,417015,16.8,92591,304334,477954,19.3,-60939,110728,141028,7.4,7,33.6
1991,Hawaii,2,33266,432427,19376,3547,13.5,1510,2368,9,1493,42101,75367,17.4,10270,47117,66493,15.4,8874,21514,26947,7.7,4.5,30.8
1991,Idaho,3.7,22403,300810,15293,3232,13.8,1393,2238,9.5,1384,34952,57355,19.1,8255,31037,46330,15.4,11025,20210,23992,7.4,5.1,30.8
1991,Illinois,-0.2,272756,4577187,211359,28231,11.6,14640,23286,9.6,14479,399344,672100,14.7,109221,471093,682452,14.9,-10352,201406,244919,6,4.6,29.4
1991,Indiana,-0.9,121954,2118027,94996,13543,11.7,7008,10656,9.2,6926,175748,297702,14.1,52981,223128,318124,15,-20422,93769,117452,5.8,4.5,28.2
1991,Iowa,2,50102,1017620,37525,6972,10.5,3455,5312,8,3419,96704,146806,14.4,20816,88726,126251,12.4,20555,54774,67237,4.9,3.7,24.8
1991,Kansas,0.2,60093,879003,46014,7012,11.9,3915,6116,10.4,3863,77199,137292,15.6,25690,88997,135011,15.4,2281,48877,59283,6.8,5.2,30.8
1991,Kentucky,0.6,80167,1179232,59560,8739,12.3,4719,6979,9.8,4683,108606,188773,16,35264,122521,182081,15.4,6692,58665,72020,6.8,5.1,30.8
1991,Louisiana,1.9,86306,1262182,75278,9684,12.1,5117,7905,9.9,5069,142599,228905,18.1,39181,129459,204737,16.2,24168,65002,80890,6.8,6,32.4
1991,Maine,-4.5,21100,404958,20433,3368,11.4,2109,3311,11.2,2102,30411,51511,12.7,11487,49111,69544,17.2,-18033,25173,29548,5.2,5,25.4
1991,Maryland,-3.9,116400,1771072,109939,12653,12.5,6910,11195,11.1,6824,152525,268925,15.2,51592,227756,337695,19.1,-68770,82212,101909,6.6,6.2,30.4
1991,Massachusetts,-6.1,128942,2655165,157859,14169,10.2,10311,16621,12,10168,204799,333741,12.6,77117,337793,495652,18.7,-161911,114170,137550,4.9,5.9,25.2
1991,Michigan,-2.8,191905,3323912,163671,20988,11.3,11472,17816,9.6,11298,269930,461835,13.9,87323,393061,556732,16.7,-94897,150753,186622,5.8,4.9,27.8
1991,Minnesota,-1.1,112187,1814867,97851,12134,12.2,5714,9100,9.2,5633,155843,268030,14.8,52820,190041,287892,15.9,-19862,82803,100739,6.2,5.4,29.6
1991,Mississippi,1.2,48507,729352,35613,5874,12.4,3140,4921,10.4,3118,67778,116285,15.9,20628,71308,106921,14.7,9364,39116,47929,6.7,4.9,29.4
1991,Missouri,0.9,119509,1975910,105549,14140,12.2,7647,12084,10.4,7544,209037,328546,16.6,54642,204736,310285,15.7,18261,95513,117251,6,5.3,31.4
1991,Montana,1.5,15863,220000,11195,2808,12.8,1408,2105,9.6,1397,21284,37147,16.9,7192,22702,33897,15.4,3250,19299,22338,7.2,5.1,30.8
1991,Nebraska,2.4,35081,585726,23795,4464,11.3,2264,3429,8.7,2231,52838,87919,15,14503,50048,73843,12.6,14076,33400,40077,6,4.1,25.2
1991,Nevada,1.6,39713,542356,27386,4527,17.1,1953,2992,11.3,1936,61499,101212,18.7,17740,65581,92967,17.1,8245,22934,27226,7.3,5,34.2
1991,New Hampshire,-6,25233,423405,28585,3439,12,2517,3841,13.4,2493,31509,56742,13.4,17074,53568,82153,19.4,-25411,24446,28472,6,6.8,26.8
1991,New Jersey,-4.2,175021,3124754,178773,20917,11.3,13722,21786,11.8,13612,275783,450804,14.4,87088,402780,581553,18.6,-130749,158005,184425,5.6,5.7,28.8
1991,New Mexico,3.5,38940,417522,26929,4573,14.4,2129,3459,10.9,2116,44965,83905,20.1,14617,42269,69198,16.6,14707,27094,32331,9.3,6.4,33.2
1991,New York,-4,372391,6859689,369220,47197,11.6,31215,46332,11.4,31048,568277,940668,13.7,202918,844698,1213918,17.7,-273250,350517,407232,5.4,5.4,27.4
1991,North Carolina,-3.4,152642,2614322,143023,18112,12.3,9829,15405,10.5,9695,207665,360307,13.8,69780,307939,450962,17.2,-90655,118321,148645,5.8,5.5,27.6
1991,North Dakota,2.9,13472,197234,8848,1811,10.7,981,1536,9.1,977,18456,31928,16.2,5615,17294,26142,13.3,5786,14520,17091,6.8,4.5,26.6
1991,Ohio,-1.6,222206,4196084,197271,24149,10.8,12760,20380,9.1,12631,345493,567699,13.5,103279,435586,632857,15.1,-65158,176311,225884,5.3,4.7,27
1991,Oklahoma,1.2,66400,944302,50642,8695,13,4351,6719,10.1,4316,91880,158280,16.8,28679,96903,147545,15.6,10735,55933,67825,7,5.4,31.2
1991,Oregon,2.3,78666,1011444,59672,10174,14.2,4955,7709,10.8,4868,111264,189930,18.8,30992,107468,167140,16.5,22790,60664,72684,7.8,5.9,33
1991,Pennsylvania,-1.3,243293,4538975,223119,26772,10.6,14985,23304,9.3,14753,381163,624456,13.8,107675,460925,684044,15.1,-59588,205750,253646,5.4,4.9,27.6
1991,Rhode Island,-4.5,21496,383606,19732,2439,10.2,1856,2896,12.1,1836,28973,50469,13.2,11803,48081,67813,17.7,-17344,21104,23742,5.6,5.1,26.4
1991,South Carolina,-1.3,89557,1236964,66002,9557,13.4,4531,7265,10.2,4482,100933,190490,15.4,32133,140946,206948,16.7,-16458,58022,72468,7.2,5.3,30.8
1991,South Dakota,5.4,16034,218618,8618,2208,12.2,989,1526,8.4,988,22860,38894,17.8,5264,18429,27047,12.4,11847,15927,18430,7.3,3.9,24.8
1991,Tennessee,-0.7,130950,1853527,100794,12947,12.7,6785,10592,10.4,6708,165593,296543,16,53053,208176,308970,16.7,-12427,81672,103073,7.1,5.4,32
1991,Texas,2.1,467778,5857767,393103,50053,14.2,24492,38985,11.1,24110,676692,1144470,19.5,214374,627266,1020369,17.4,124101,277327,357380,8,6.7,34.8
1991,Utah,5.1,44450,579626,30313,4739,14.6,2082,3307,10.2,2065,72546,116996,20.2,18817,57012,87325,15.1,29671,27233,33225,7.7,5.2,30.2
1991,Vermont,-4.8,11213,210592,11162,1858,10.8,1197,1832,10.7,1192,15405,26618,12.6,6894,25417,36579,17.4,-9961,15232,17207,5.3,5.3,25.2
1991,Virginia,-3.9,145398,2266314,133978,16840,12.6,9141,15030,11.3,9026,185934,331332,14.6,62711,284683,418661,18.5,-87329,104776,134097,6.4,5.9,29.2
1991,Washington,1.2,121174,1727614,104319,17247,14.9,7515,12110,10.5,7441,198564,319738,18.5,48589,193747,298066,17.3,21672,98342,118435,7,6,34.6
1991,West Virginia,0.6,33305,481431,22048,3985,11.7,2073,3257,9.6,2052,40178,73483,15.3,13523,48865,70913,14.7,2570,28321,34474,6.9,4.6,29.4
1991,Wisconsin,0.7,103347,1931269,76213,12429,11.3,6113,9237,8.4,6022,160511,263858,13.7,43264,175739,251952,13,11906,92050,111392,5.4,3.9,26
1991,Wyoming,4.2,9213,132036,5751,1681,13.2,762,1179,9.2,759,15315,24528,18.6,3866,13299,19050,14.4,5478,11227,13014,7,4.4,28.8
1992,Alabama,1.7,76427,1346402,67093,10063,12.6,5574,8215,10.3,5494,144192,220619,16.4,37434,130663,197756,14.7,22863,63918,80283,5.7,5,29.4
1992,Alaska,2.9,12401,162050,9499,1968,15.1,860,1419,10.9,846,23607,36008,22.2,5463,21776,31275,19.3,4733,10879,13231,7.7,5.9,38.6
1992,Arizona,0.3,99526,1248051,98726,11685,14.9,6434,10040,12.8,6257,147052,246578,19.8,43024,144297,243023,19.5,3555,63128,78859,8,7.9,39
1992,Arkansas,2.7,44686,773067,38106,6354,12.9,3614,5200,10.6,3558,88407,133093,17.2,21298,74141,112247,14.5,20846,41160,49488,5.8,4.9,29
1992,California,-2.4,813263,10732102,797104,87403,13.3,55671,85165,12.9,54681,1167373,1980636,18.5,436805,1446519,2243623,20.9,-262987,529679,656532,7.6,7.4,37
1992,Colorado,3.5,100552,1292916,84683,12983,14.7,6612,10311,11.7,6499,153987,254539,19.7,45003,124674,209357,16.2,45182,74094,89165,7.8,6.5,32.4
1992,Connecticut,-2.5,68031,1423706,72314,8432,10.5,5916,9147,11.4,5837,129540,197571,13.9,36640,161184,233498,16.4,-35927,67353,79633,4.8,5.1,27.8
1992,Delaware,-3.2,16844,306365,20740,2285,13.7,1084,1872,11.2,1078,27691,44535,14.5,6205,33349,54089,17.7,-9554,14035,16883,5.5,6.8,29
1992,District of Columbia,3.7,36171,394956,16642,1985,11.2,1015,1784,10.1,1001,36535,72706,18.4,8118,41594,58236,14.7,14470,14639,17712,9.2,4.2,29.4
1992,Florida,0.6,383699,4541774,361525,50409,15.7,28545,42391,13.2,28019,520326,904025,19.9,186814,513836,875361,19.3,28664,263140,324622,8.4,8,38.6
1992,Geogia,2.2,180370,2476106,169463,20113,14.1,10466,16666,11.7,10233,287942,468312,18.9,78970,242903,412366,16.7,55946,113048,143866,7.3,6.8,33.4
1992,Hawaii,2.3,25427,441837,20482,3140,11.6,1788,2794,10.3,1756,51436,76863,17.4,10274,46029,66511,15.1,10352,21464,27167,5.8,4.6,30.2
1992,Idaho,5.7,26722,315744,15977,3552,14.5,1611,2485,10.1,1591,38474,65196,20.6,9548,31044,47021,14.9,18175,21016,24955,8.5,5.1,29.8
1992,Illinois,1.1,274538,4579284,225520,28583,11.6,15396,24543,10,15142,481416,755954,16.5,108970,478625,704145,15.4,51809,202758,247905,6,4.9,30.8
1992,Indiana,2.3,129067,2130456,98676,13643,11.5,7408,11239,9.5,7282,216178,345245,16.2,51973,198404,297080,13.9,48165,94728,119531,6.1,4.6,27.8
1992,Iowa,0.6,57266,1023283,47465,7059,10.4,3875,5932,8.8,3821,98748,156014,15.2,24541,101537,149002,14.6,7012,55206,68184,5.6,4.6,29.2
1992,Kansas,0.9,53039,883294,46138,7109,11.9,3893,5939,9.9,3831,87064,140103,15.9,26719,86313,132451,15,7652,49393,60233,6,5.2,30
1992,Kentucky,1.2,63288,1189978,58632,8704,12,5174,7525,10.4,5114,118443,181731,15.3,33801,109703,168335,14.1,13396,59039,72943,5.3,4.9,28.2
1992,Louisiana,1.8,80995,1284338,74304,9854,12.1,5421,8308,10.2,5292,157263,238258,18.6,40216,140854,215158,16.8,23100,65815,82139,6.3,5.8,33.6
1992,Maine,-1.9,20899,391145,22696,3375,11.4,2093,3238,11,2054,35180,56079,14.3,10969,40819,63515,16.2,-7436,24977,29470,5.3,5.8,28.6
1992,Maryland,-1.3,107603,1723791,97369,12701,12.4,6755,11132,10.8,6609,177908,285511,16.6,46573,211554,308923,17.9,-23412,82786,103147,6.2,5.6,33.2
1992,Massachusetts,-1,135569,2559000,135513,14705,10.7,9426,14970,10.9,9271,247915,383484,15,66267,274518,410031,16,-26547,112484,136582,5.3,5.3,30
1992,Michigan,1.6,167285,3301018,150402,21177,11.2,10834,17652,9.4,10678,352978,520263,15.8,76009,318133,468535,14.2,51728,152282,189397,5.1,4.6,28.4
1992,Minnesota,2.3,97946,1822713,87576,12065,11.9,6324,9970,9.8,6204,193085,291031,16,44057,162508,250084,13.7,40947,83751,102474,5.4,4.8,27.4
1992,Mississippi,1.4,37542,734471,35435,5798,12,3354,5075,10.5,3314,79676,117218,16,19983,71606,107041,14.6,10177,39423,48416,5.1,4.8,29.2
1992,Missouri,0.6,108320,1987304,97840,14246,12.1,8040,12404,10.5,7913,202522,310842,15.6,48897,200978,298818,15,12024,96336,118633,5.5,4.9,30
1992,Montana,6.3,15091,228382,12150,3069,13.5,1548,2302,10.1,1533,30292,45383,19.9,7912,18877,31027,13.6,14356,19780,23061,6.6,5.3,27.2
1992,Nebraska,1.8,30305,594127,25394,4442,11,2411,3692,9.1,2366,59437,89742,15.1,14040,53424,78818,13.3,10924,33831,40666,5.1,4.3,26.6
1992,Nevada,0,39364,546736,30477,4589,16.6,2367,3592,13,2343,53012,92376,16.9,16144,61823,92300,16.9,76,23416,28079,7.2,5.6,33.8
1992,New Hampshire,0.7,25656,411639,22538,3616,12.7,2292,3332,11.7,2250,42450,68106,16.5,13925,42541,65079,15.8,3027,24211,28590,6.2,5.5,31.6
1992,New Jersey,-0.2,159478,3044202,163938,21104,11.4,12978,20403,11.1,12842,342884,502362,16.5,73121,345252,509190,16.7,-6828,157103,183921,5.2,5.4,33
1992,New Mexico,3.1,34614,428861,27287,4599,14.1,2322,3677,11.2,2278,55221,89835,20.9,13989,49103,76390,17.8,13445,27468,33023,8.1,6.4,35.6
1992,New York,-0.3,381653,6676973,368634,46121,11.4,33001,47403,11.7,32517,694328,1075981,16.1,197188,724405,1093039,16.4,-17058,345484,403364,5.7,5.5,32.2
1992,North Carolina,2.4,149148,2596790,131811,17939,12,9961,15352,10.2,9813,276156,425304,16.4,60525,231911,363722,14,61582,119096,150549,5.7,5.1,28
1992,North Dakota,2.7,10931,202318,8949,1825,10.6,1060,1612,9.4,1047,20572,31503,15.6,5142,17126,26075,12.9,5428,14514,17226,5.4,4.4,25.8
1992,Ohio,0.2,194745,4161441,181546,23913,10.5,13463,21555,9.5,13219,398528,593273,14.3,86135,405152,586698,14.1,6575,176694,227682,4.7,4.4,28.2
1992,Oklahoma,0.6,59875,950584,58979,8789,12.8,5130,7390,10.8,5040,100375,160250,16.9,31593,96074,155053,16.3,5197,56510,68949,6.3,6.2,32.6
1992,Oregon,0.5,68390,1022136,59332,10166,13.8,5196,8043,10.9,5131,110034,178424,17.5,32875,114525,173857,17,4567,61952,74465,6.7,5.8,34
1992,Pennsylvania,-0.6,227241,4488384,214803,25601,10.1,16115,24738,9.7,15873,408920,636161,14.2,103202,450509,665312,14.8,-29151,204368,253696,5.1,4.8,28.4
1992,Rhode Island,-2.8,18093,367863,22229,2590,11,1803,2734,11.6,1775,33760,51853,14.1,12307,40029,62258,16.9,-10405,20701,23354,4.9,6,28.2
1992,South Carolina,1.6,75754,1241171,58743,9238,12.6,5122,7882,10.8,5055,122930,198684,16,31848,120346,179089,14.4,19595,58601,73449,6.1,4.7,28.8
1992,South Dakota,4.1,13577,229407,11517,2201,11.8,1196,1815,9.7,1185,26383,39960,17.4,6948,19060,30577,13.3,9383,16093,18764,5.9,5,26.6
1992,Tennessee,2.6,109151,1868443,99882,13044,12.6,7246,11228,10.8,7132,212388,321539,17.2,49124,172625,272507,14.6,49032,82534,104471,5.8,5.3,29.2
1992,Texas,1.4,470128,5950058,398255,51501,14.2,27201,42127,11.6,26555,685998,1156126,19.4,206550,670520,1068775,18,87351,282598,365314,7.9,6.7,36
1992,Utah,3.1,43472,603564,41182,4999,14.8,2449,3789,11.2,2414,74799,118271,19.6,23583,58678,99860,16.5,18411,28181,34343,7.2,6.8,33
1992,Vermont,0.9,11337,205790,9135,1903,11.1,1200,1776,10.3,1194,19910,31247,15.2,6082,20256,29391,14.3,1856,15163,17195,5.5,4.4,28.6
1992,Virginia,0.7,141088,2231301,125790,17097,12.7,9197,14825,11,8969,233206,374294,16.8,62989,233861,359651,16.1,14643,105795,135803,6.3,5.6,32.2
1992,Washington,3,119751,1761545,109327,18240,15.1,8554,13279,11,8458,232890,352641,20,50743,189696,299023,17,53618,101511,122631,6.8,6.2,34
1992,West Virginia,-0.4,25278,481350,26888,3828,11,2121,3382,9.8,2104,47471,72749,15.1,12299,47951,74839,15.5,-2090,28485,34743,5.3,5.6,30.2
1992,Wisconsin,1.7,86215,1954788,79130,11883,10.6,6480,10101,9,6406,186864,273079,14,38972,162265,241395,12.3,31684,92741,112804,4.4,4,24.6
1992,Wyoming,1.8,8672,135874,7409,1710,13,764,1301,9.9,757,16239,24911,18.3,4371,15033,22442,16.5,2469,11513,13338,6.4,5.5,33
1993,Alabama,2.7,64949,1383184,61198,9482,11.7,5360,7837,9.7,5343,152736,217685,15.7,31016,118110,179308,13,38377,65394,81689,4.7,4.4,26
1993,Alaska,1.8,9464,165637,9148,1737,13,848,1451,10.9,840,22174,31638,19.1,4586,19551,28699,17.3,2939,11184,13481,5.7,5.5,34.6
1993,Arizona,3.7,90983,1274754,78183,11194,14,6028,9275,11.6,5987,158866,249849,19.6,37389,124075,202258,15.9,47591,65112,80516,7.1,6.1,31.8
1993,Arkansas,3.8,42142,797039,35748,6164,12.3,3489,4870,9.7,3445,88275,130417,16.4,18979,64749,100497,12.6,29920,42387,50628,5.3,4.5,25.2
1993,California,-0.5,669902,10547691,717950,75603,11.6,54099,82362,12.7,53343,1242824,1912726,18.1,337326,1242754,1960704,18.6,-47978,523374,645597,6.4,6.8,36.2
1993,Colorado,4.7,86970,1345000,73079,13173,14.5,6127,9490,10.4,6093,170260,257230,19.1,35660,120298,193377,14.4,63853,77907,92656,6.5,5.4,28.8
1993,Connecticut,-0.3,59721,1402788,60131,7808,9.8,5054,7696,9.7,5023,146873,206594,14.7,29100,149841,209972,15,-3378,67538,79579,4.3,4.3,29.4
1993,Delaware,0.8,16479,302401,15455,2026,11.9,1047,1745,10.3,1045,30980,47459,15.7,6557,29605,45060,14.9,2399,14343,17100,5.4,5.1,29.8
1993,District of Columbia,6,16050,414809,18062,1618,9.2,931,1813,10.3,927,62321,78371,18.9,6106,35354,53416,12.9,24955,14585,17491,3.9,4.4,25.8
1993,Florida,3.7,368147,4644368,312395,48544,14.8,28105,39997,12.2,27778,589430,957577,20.6,175123,472521,784916,16.9,172661,272178,332350,7.9,6.7,33.8
1993,Geogia,3,162589,2540489,135669,19231,13.2,10003,15262,10.5,9955,286128,448717,17.7,66232,238751,374420,14.7,74297,117021,147510,6.4,5.3,29.4
1993,Hawaii,-3.3,21333,438664,22087,2824,10.4,1848,2806,10.4,1840,37688,59021,13.5,10282,51749,73836,16.8,-14815,21464,27064,4.9,5,27
1993,Idaho,2.9,20819,329085,16253,3427,13.5,1646,2518,9.9,1644,38181,59000,17.9,9368,33003,49256,15,9744,21841,25761,6.3,4.9,30
1993,Illinois,0.5,233014,4609541,205150,26409,10.6,14889,22911,9.2,14781,462017,695031,15.1,89863,465584,670734,14.6,24297,206074,250735,5.1,4.5,29.2
1993,Indiana,2.5,94277,2180336,86940,12591,10.5,7135,10483,8.7,7089,230055,324332,14.9,43290,184321,271261,12.4,53071,96817,121418,4.3,4,24.8
1993,Iowa,1.8,41013,1035736,35761,6226,9.1,3787,5617,8.2,3768,96802,137815,13.3,19290,83208,118969,11.5,18846,55783,68639,4,3.5,23
1993,Kansas,1.2,41789,891512,39453,6421,10.6,3753,5599,9.2,3722,87268,129057,14.5,21944,79294,118747,13.3,10310,50181,60925,4.7,4.4,26.6
1993,Kentucky,3.4,66685,1216362,56104,8334,11.3,4885,7173,9.8,4861,129303,195988,16.1,28067,98841,154945,12.7,41043,60115,73934,5.5,4.6,25.4
1993,Louisiana,1,73452,1301148,67445,9085,11,5260,7729,9.3,5236,146961,220413,16.9,38046,139858,207303,15.9,13110,67301,83407,5.6,5.2,31.8
1993,Maine,4.3,24220,395352,17940,3264,11,1940,2906,9.8,1917,42433,66653,16.9,9508,31835,49775,12.6,16878,25253,29690,6.1,4.5,25.2
1993,Maryland,-0.2,95294,1708351,91177,11932,11.5,6583,10935,10.6,6522,174121,269415,15.8,45729,181703,272880,16,-3465,84307,103875,5.6,5.3,31.6
1993,Massachusetts,1.8,125931,2567055,116624,13717,10,8519,13077,9.6,8411,276078,402009,15.7,51185,240064,356688,13.9,45321,113330,136982,4.9,4.5,27.8
1993,Michigan,2.2,154486,3361977,134966,19527,10.3,11357,17211,9,11274,352923,507409,15.1,67692,297381,432347,12.9,75062,154549,191270,4.6,4,25.8
1993,Minnesota,3.3,98980,1874729,75485,11352,11,5693,8712,8.4,5627,193009,291989,15.6,36385,154193,229678,12.3,62311,86216,104867,5.3,4,24.6
1993,Mississippi,3.8,45463,754275,38000,5852,12,3418,4752,9.7,3410,81202,126665,16.8,20646,60025,98025,13,28640,40418,49450,6,5,26
1993,Missouri,0.7,95582,1999829,96931,13511,11.3,7949,11697,9.8,7881,198719,294301,14.7,49493,183353,280284,14,14017,98232,120257,4.8,4.8,28
1993,Montana,3.4,15731,238202,11835,2807,12.1,1596,2319,10,1586,27331,43062,18.1,7884,23209,35044,14.7,8018,20244,23467,6.6,5,29.4
1993,Nebraska,2.3,26530,606482,21526,4003,9.8,2409,3553,8.7,2398,60324,86854,14.3,11995,51266,72792,12,14062,34218,41023,4.4,3.5,24
1993,Nevada,4.3,40568,557565,29621,4404,15.5,2322,3532,12.4,2289,61302,101870,18.3,17443,48629,78250,14,23620,24180,28788,7.3,5.3,28
1993,New Hampshire,1.6,21454,416203,19890,3244,11.3,1984,3006,10.5,1976,42630,64084,15.4,9353,37349,57239,13.8,6845,24402,28745,5.2,4.8,27.6
1993,New Jersey,0.5,153993,3051256,149481,20496,11.1,12029,18032,9.7,11983,339327,493320,16.2,64480,329039,478520,15.7,14800,159542,186014,5,4.9,31.4
1993,New Mexico,3.5,28707,442894,23351,4252,12.7,2258,3395,10.2,2255,54137,82844,18.7,11832,44147,67498,15.2,15346,28429,33868,6.5,5.3,30.4
1993,New York,-0.9,339819,6618134,320965,44518,11,30582,43521,10.8,30398,666967,1006786,15.2,165063,747120,1068085,16.1,-61299,346038,403359,5.1,4.8,30.4
1993,North Carolina,2.6,124381,2665585,110538,16716,11,9536,14088,9.3,9465,281672,406053,15.2,56224,224092,334630,12.6,71423,121364,152781,4.7,4.1,25.2
1993,North Dakota,3.3,9879,208522,7644,1696,9.8,978,1431,8.3,976,20447,30326,14.5,4535,15701,23345,11.2,6981,14735,17451,4.7,3.7,22.4
1993,Ohio,2,191069,4206104,181386,22123,9.7,12784,20558,9,12654,436939,628008,14.9,77428,362644,544030,12.9,83978,179233,228860,4.5,4.3,25.8
1993,Oklahoma,2.4,56347,964462,48341,8068,11.6,4674,6921,10,4652,102832,159179,16.5,24824,87382,135723,14.1,23456,57797,69955,5.8,5,28.2
1993,Oregon,2.9,59020,1038875,51948,9445,12.6,5084,7806,10.4,5056,121397,180417,17.4,25547,99097,151045,14.5,29372,63624,75844,5.7,5,29
1993,Pennsylvania,0.6,199415,4486581,186450,22871,9,15156,22817,9,15039,422690,622105,13.9,91771,412034,598484,13.3,23621,204517,253027,4.4,4.2,26.6
1993,Rhode Island,2.5,21994,367391,17028,2581,11,1468,2234,9.5,1463,35480,57474,15.6,7915,31063,48091,13.1,9383,21054,23688,6,4.6,26.2
1993,South Carolina,1.8,63611,1264276,55605,8759,11.8,4910,7283,9.8,4886,122805,186416,14.7,25552,107607,163212,12.9,23204,59863,74751,5,4.4,25.8
1993,South Dakota,4.4,14321,239186,10676,2029,10.7,1125,1650,8.7,1115,25097,39418,16.5,5551,18381,29057,12.1,10361,16460,19109,6,4.5,24.2
1993,Tennessee,2.8,102637,1918641,85139,12427,11.8,6787,10128,9.6,6705,212275,314912,16.4,42833,176702,261841,13.6,53071,84669,106500,5.3,4.4,27.2
1993,Texas,2.9,410514,6078760,373822,47588,12.9,26434,40533,11,26186,773750,1184264,19.5,182144,632901,1006723,16.6,177541,290051,371330,6.8,6.1,33.2
1993,Utah,5.6,38700,630258,33761,4941,14.1,2397,3617,10.4,2383,78102,116802,18.5,18113,47682,81443,12.9,35359,29422,35529,6.1,5.4,25.8
1993,Vermont,3,10379,210647,9491,1932,11.2,1144,1660,9.6,1142,21054,31433,14.9,5405,15604,25095,11.9,6338,15434,17460,4.9,4.5,23.8
1993,Virginia,6.4,127448,2310575,104246,15718,11.5,8458,13294,9.7,8403,339997,467445,20.2,48035,214779,319025,13.8,148420,108229,137903,5.5,4.5,27.6
1993,Washington,1.3,106150,1817669,96683,16684,13.4,8687,13251,10.7,8618,198210,304360,16.7,48839,183494,280177,15.4,24183,104643,125528,5.8,5.3,30.8
1993,West Virginia,1.4,21231,483328,21332,3487,10,2107,3143,9,2091,49775,71006,14.7,11248,42815,64147,13.3,6859,28810,35012,4.4,4.4,26.6
1993,Wisconsin,2.8,89099,1999055,77760,11771,10.3,6497,9501,8.3,6420,198534,287633,14.4,39149,153393,231153,11.6,56480,94771,114878,4.5,3.9,23.2
1993,Wyoming,2.1,10617,139356,7634,1855,13.7,885,1337,9.8,876,14803,25420,18.2,4694,14785,22419,16.1,3001,11868,13822,7.6,5.5,32.2
1994,Alabama,2.3,84306,1415009,63659,10389,12.6,5518,8070,9.8,5492,137362,221668,15.7,36087,125798,189457,13.4,32211,67204,83751,6,4.5,26.8
1994,Alaska,2.7,12698,169205,9253,1814,13.3,847,1437,10.5,841,21317,34015,20.1,3908,20172,29425,17.4,4590,11511,13796,7.5,5.5,34.8
1994,Arizona,6.7,113564,1341461,77888,12639,15.4,6204,9122,11.1,6185,178619,292183,21.8,39110,124770,202658,15.1,89525,67685,83748,8.5,5.8,30.2
1994,Arkansas,2.6,52223,821074,45335,6622,12.9,3628,5046,9.8,3616,81528,133751,16.3,24531,67422,112757,13.7,20994,43467,52021,6.4,5.5,27.4
1994,California,-0.4,700042,10483851,682970,80453,12.5,51500,79079,12.3,51095,1101752,1801794,17.2,361010,1159984,1842954,17.6,-41160,522330,643643,6.7,6.5,34.4
1994,Colorado,4.2,104037,1404918,80050,14746,15.5,6670,9880,10.4,6642,162739,266776,19,39229,128093,208143,14.8,58633,81787,97238,7.4,5.7,29.6
1994,Connecticut,-1.3,61086,1386909,69347,8129,10.2,5017,7555,9.5,4994,129755,190841,13.8,37964,140147,209494,15.1,-18653,67788,79927,4.4,5,27.6
1994,Delaware,8,17330,316508,11910,2201,12.7,1022,1670,9.6,1022,53962,71292,22.5,5436,33954,45864,14.5,25428,14714,17592,5.5,3.8,29
1994,District of Columbia,-5.3,19632,419062,14736,1787,10.2,924,1568,8.9,903,34180,53812,12.8,5120,61232,75968,18.1,-22156,14706,17665,4.7,3.5,25.6
1994,Florida,4.1,369007,4817216,289054,49400,14.7,29079,40623,12.1,28951,583144,952151,19.8,175612,468058,757112,15.7,195039,278292,339954,7.7,6,31.4
1994,Geogia,4.4,181930,2625414,140539,20675,13.8,10682,16053,10.7,10626,294747,476677,18.2,66569,221311,361850,13.8,114827,120395,151723,6.9,5.4,27.6
1994,Hawaii,-2,26245,426549,25343,2794,10.3,1780,2674,9.9,1746,34311,60556,14.2,13709,43775,69118,16.2,-8562,21493,27075,6.2,5.9,28.4
1994,Idaho,6.7,25521,344819,16801,4031,15.2,1713,2519,9.5,1702,43306,68827,20,9791,29065,45866,13.3,22961,23087,27136,7.4,4.9,26.6
1994,Illinois,2.5,244959,4674579,197026,27674,10.9,14986,22759,9,14934,467280,712239,15.2,95938,398277,595303,12.7,116936,209382,254937,5.2,4.2,25.4
1994,Indiana,2.4,112216,2233858,97635,13463,11,7190,10684,8.7,7144,223133,335349,15,41701,184433,282068,12.6,53281,98822,123919,5,4.4,25.2
1994,Iowa,2.1,49070,1054185,44435,6899,10,3893,5752,8.3,3879,97634,146704,13.9,20341,80470,124905,11.8,21799,56457,69542,4.7,4.2,23.6
1994,Kansas,3.3,51368,911281,40293,7055,11.5,3920,5763,9.4,3875,92372,143740,15.8,21570,73440,113733,12.5,30007,51161,62065,5.6,4.4,25
1994,Kentucky,2.7,71825,1253328,53943,8584,11.5,4862,7037,9.4,4848,125422,197247,15.7,30478,108741,162684,13,34563,61120,75269,5.7,4.3,26
1994,Louisiana,2.9,83022,1324235,61101,10009,11.9,5452,8060,9.6,5422,143098,226120,17.1,34384,126679,187780,14.2,38340,68703,85118,6.3,4.6,28.4
1994,Maine,1.5,21311,405680,19396,3454,11.6,2007,2885,9.6,2003,41114,62425,15.4,11389,36937,56333,13.9,6092,25592,30119,5.3,4.8,27.8
1994,Maryland,1.4,100420,1715818,88729,12274,11.7,6575,10447,10,6504,183284,283704,16.5,40183,171149,259878,15.1,23826,85659,105413,5.9,5.2,30.2
1994,Massachusetts,1,124243,2600319,117629,14973,10.9,8227,12678,9.2,8193,266446,390689,15,56955,247078,364707,14,25982,115026,138955,4.8,4.5,28
1994,Michigan,2.5,180540,3444715,163418,20743,10.7,11307,16779,8.7,11186,352359,532899,15.5,73811,283033,446451,13,86448,157355,194789,5.2,4.7,26
1994,Minnesota,2.8,94187,1929655,79639,12103,11.4,5884,8942,8.4,5858,191082,285269,14.8,40071,152708,232347,12,52922,88527,107753,4.9,4.1,24
1994,Mississippi,6.3,62745,791400,36863,6016,12.1,3704,5173,10.4,3688,86608,149353,18.9,19477,63045,99908,12.6,49445,40993,50131,7.9,4.7,25.2
1994,Missouri,2.9,109709,2035599,92012,14935,12.3,8322,12102,10,8293,209556,319265,15.7,49093,168902,260914,12.8,58351,100222,122714,5.4,4.5,25.6
1994,Montana,1,15227,244093,12682,3088,13,1615,2292,9.6,1615,24591,39818,16.3,7487,24687,37369,15.3,2449,20871,24169,6.2,5.2,30.6
1994,Nebraska,2.6,33018,620506,27913,4384,10.6,2429,3548,8.6,2421,58728,91746,14.8,13544,47630,75543,12.2,16203,34734,41715,5.3,4.5,24.4
1994,Nevada,8.6,47095,594536,34195,5006,16.9,2304,3372,11.4,2298,85183,132278,22.2,22040,46847,81042,13.6,51236,25550,30321,7.9,5.8,27.2
1994,New Hampshire,4.3,24228,428459,19791,3642,12.5,1923,2896,10,1922,47905,72133,16.8,9644,33632,53423,12.5,18710,24930,29374,5.7,4.6,25
1994,New Jersey,0.2,166225,3059172,158587,21358,11.4,12337,18728,10,12256,299476,465701,15.2,77345,298836,457423,15,8278,161132,188124,5.4,5.2,30
1994,New Mexico,4.4,33715,459751,25703,4758,13.8,2497,3581,10.4,2489,54612,88327,19.2,14218,42473,68176,14.8,20151,29254,34918,7.3,5.6,29.6
1994,New York,-0.1,337489,6575682,319700,45895,11.4,30566,43644,10.8,30401,623601,961090,14.6,176252,649638,969338,14.7,-8248,346091,404479,5.1,4.9,29.2
1994,North Carolina,3.9,154076,2752790,110356,18552,12,9514,13896,9,9470,279300,433376,15.7,58547,214144,324500,11.8,108876,124616,156906,5.6,4,23.6
1994,North Dakota,2.9,9451,214997,7487,1747,9.9,980,1437,8.2,978,21169,30620,14.2,4376,16863,24350,11.3,6270,14999,17739,4.4,3.5,22.6
1994,Ohio,2.5,222206,4273013,171797,24152,10.5,12805,19761,8.6,12673,416843,639049,15,77492,362842,534639,12.5,104410,182111,232762,5.2,4,25
1994,Oklahoma,2.1,57988,985381,47902,8687,12.3,4911,6913,9.8,4906,100754,158742,16.1,27235,90305,138207,14,20535,59055,71479,5.9,4.9,28
1994,Oregon,5.1,74720,1080056,51367,11027,14.2,5084,7610,9.8,5071,122952,197672,18.3,26370,91302,142669,13.2,55003,66290,79009,6.9,4.8,26.4
1994,Pennsylvania,0.6,219667,4500087,206850,23743,9.4,14995,22356,8.8,14883,406953,626620,13.9,100223,393320,600170,13.3,26450,204123,253624,4.9,4.6,26.6
1994,Rhode Island,-1.8,21981,369123,19637,2666,11.2,1605,2385,10,1601,31369,53350,14.5,9608,40436,60073,16.3,-6723,21332,23939,6,5.3,29
1994,South Carolina,3.4,84016,1295372,61326,9211,12.2,5059,7440,9.9,5042,127979,211995,16.4,32212,106686,168012,13,43983,60991,76229,6.5,4.7,26
1994,South Dakota,3.4,15416,248034,11968,2288,11.8,1178,1685,8.7,1175,24591,40007,16.1,7284,19539,31507,12.7,8500,16860,19622,6.2,4.8,25.4
1994,Tennessee,3.2,122031,1974443,96074,12984,12.1,6955,10231,9.5,6919,199078,321109,16.3,45748,162699,258773,13.1,62336,86567,108939,6.2,4.9,26.2
1994,Texas,2.1,432105,6221921,347802,50661,13.5,27054,40123,10.7,26915,688167,1120272,18,172658,641411,989213,15.9,131059,297469,380583,6.9,5.6,31.8
1994,Utah,6.3,47354,668105,34331,5781,15.9,2622,3802,10.4,2613,80777,128131,19.2,19701,51936,86267,12.9,41864,31010,37419,7.1,5.1,25.8
1994,Vermont,1.8,9996,215493,9178,1922,10.9,1087,1583,9,1082,20098,30094,14,4970,17024,26202,12.2,3892,15671,17725,4.6,4.3,24.4
1994,Virginia,-1.7,135017,2363292,104294,16525,11.9,8400,13195,9.5,8361,236694,371711,15.7,46036,306761,411055,17.4,-39344,110799,140918,5.7,4.4,31.4
1994,Washington,1.7,113646,1843105,87998,17889,14.1,9150,13678,10.7,9127,196688,310334,16.8,48116,189502,277500,15.1,32834,107728,129097,6.2,4.8,30.2
1994,West Virginia,2.4,27317,492295,21064,3863,10.9,1987,2961,8.4,1982,49053,76370,15.5,10466,43217,64281,13.1,12089,29426,35811,5.5,4.3,26.2
1994,Wisconsin,2.4,94337,2049898,69270,11975,10.3,6604,9661,8.3,6566,183119,277456,13.5,38191,157547,226817,11.1,50639,96234,116838,4.6,3.4,22.2
1994,Wyoming,4.7,10682,143943,6685,1862,13.2,851,1260,8.9,849,16201,26883,18.7,4112,13515,20200,14,6683,12355,14366,7.4,4.6,28
1995,Alabama,5.2,86798,1467007,60000,10622,12.5,5705,8166,9.6,5662,164031,250829,17.1,33571,114755,174755,11.9,76074,68976,85909,5.9,4.1,23.8
1995,Alaska,1.9,11715,172692,8862,1882,13.5,952,1472,10.5,943,19419,31134,18,4957,18935,27797,16.1,3337,11847,14143,6.8,5.1,32.2
1995,Arizona,6.6,114600,1432500,74201,12940,15.2,6540,9572,11.2,6436,180298,294898,20.6,41490,126209,200410,14,94488,70159,86610,8,5.2,28
1995,Arkansas,5.2,50414,852651,41891,6889,13.1,3754,5251,10,3749,95796,146210,17.1,23336,59964,101855,11.9,44355,44595,53484,5.9,4.9,23.8
1995,California,2.9,667725,10614063,561589,82358,12.7,49295,73802,11.4,48884,1214349,1882074,17.7,295961,1006334,1567923,14.8,314151,526482,648641,6.3,5.3,29.6
1995,Colorado,6,119087,1478714,74051,15212,15.3,6988,10433,10.5,6966,179259,298346,20.2,42727,135302,209353,14.2,88993,85450,101591,8.1,5,28.4
1995,Connecticut,1.3,73542,1383830,56813,8641,10.7,4839,7346,9.1,4784,123492,197034,14.2,25884,122203,179016,12.9,18018,68746,81012,5.3,4.1,25.8
1995,Delaware,5.9,17283,314074,13275,2319,13,1092,1724,9.7,1087,38797,56080,17.9,6034,24397,37672,12,18408,15180,18141,5.5,4.2,24
1995,District of Columbia,0,17561,407790,17520,1801,10.2,929,1653,9.3,923,39439,57000,14,7438,39419,56939,14,61,14755,17774,4.3,4.3,28
1995,Florida,4.4,416656,5010695,308071,49651,14.5,29457,41223,12,29295,588949,1005605,20.1,180357,479225,787296,15.7,218309,283724,346872,8.3,6.1,31.4
1995,Geogia,6.3,211358,2770099,140209,21751,14.1,10585,15910,10.3,10532,326434,537792,19.4,71666,223038,363247,13.1,174545,124444,156989,7.6,5.1,26.2
1995,Hawaii,0.3,25371,421647,18763,2864,10.6,1796,2637,9.7,1787,32366,57737,13.7,8445,37783,56546,13.4,1191,21547,27194,6,4.4,26.8
1995,Idaho,3.5,24536,361497,21718,3978,14.4,1939,2862,10.4,1934,40548,65084,18,9114,30568,52286,14.5,12798,24017,28116,6.8,6,29
1995,Illinois,2.9,256602,4800455,197813,28881,11.2,15104,23320,9.1,15017,487428,744030,15.5,97424,405510,603323,12.6,140707,213113,259721,5.3,4.1,25.2
1995,Indiana,4.5,126697,2311145,85301,14422,11.5,7522,11140,8.9,7490,239852,366549,15.9,43487,178947,264248,11.4,102301,100740,126812,5.5,3.7,22.8
1995,Iowa,4.2,54375,1086338,43338,7122,10.2,4059,5962,8.5,4045,106115,160490,14.8,20812,72288,115626,10.6,44864,57097,70481,5,4,21.2
1995,Kansas,3.3,50866,940378,37831,7112,11.4,4007,5787,9.2,3984,89007,139873,14.9,20646,70963,108794,11.6,31079,52006,63151,5.4,4,23.2
1995,Kentucky,4.2,76903,1296623,58104,8909,11.7,4900,7091,9.3,4880,136186,213089,16.4,30133,100684,158788,12.2,54301,62220,76787,5.9,4.5,24.4
1995,Louisiana,3.4,93466,1363101,76292,9912,11.6,5540,8178,9.5,5486,150414,243880,17.9,38899,121768,198060,14.5,45820,69816,86523,6.9,5.6,29
1995,Maine,3,21243,414733,17044,3646,12,2015,2980,9.8,2010,41320,62563,15.1,9920,33004,50048,12.1,12515,26167,30688,5.1,4.1,24.2
1995,Maryland,4.2,104957,1762752,81931,13076,12.3,6809,10474,9.8,6763,194488,299445,17,40782,142823,224754,12.8,74691,87612,107686,6,4.6,25.6
1995,Massachusetts,2.9,135246,2650051,112220,16085,11.5,8279,12878,9.2,8204,271749,406995,15.4,54833,218439,330659,12.5,76336,117390,141833,5.1,4.2,25
1995,Michigan,4.7,210096,3569755,144992,22284,11.3,11415,17149,8.7,11363,387444,597540,16.7,72549,283342,428334,12,169206,161096,199288,5.9,4.1,24
1995,Minnesota,4.7,118805,1999258,74186,12156,11.2,6108,9487,8.7,6068,194194,312999,15.7,40151,146217,220403,11,92596,90383,109932,5.9,3.7,22
1995,Mississippi,4,58406,831653,40151,6227,12.3,3525,5015,9.9,3518,86364,144770,17.4,22708,71615,111766,13.4,33004,41773,51152,7,4.8,26.8
1995,Missouri,3.5,118156,2098938,93501,15006,12.1,8437,12286,9.9,8397,223459,341615,16.3,47136,174441,267942,12.8,73673,101932,124894,5.6,4.5,25.6
1995,Montana,4.7,17622,250389,12724,3317,13.5,1730,2393,9.8,1727,25886,43508,17.4,8467,19174,31898,12.7,11610,21493,24898,7,5.1,25.4
1995,Nebraska,4.6,31771,642471,24008,4256,10.1,2455,3555,8.5,2445,65808,97579,15.2,12227,44138,68146,10.6,29433,35077,42237,4.9,3.7,21.2
1995,Nevada,6.9,53865,640958,29020,5405,17.4,2523,3626,11.7,2518,71667,125532,19.6,17854,52573,81593,12.7,43939,26897,31949,8.4,4.5,25.4
1995,New Hampshire,5,30385,448680,20118,3843,12.9,1907,2870,9.6,1901,45432,75817,16.9,10675,33492,53610,11.9,22207,25726,30296,6.8,4.5,23.8
1995,New Jersey,2.4,172419,3100003,145942,23192,12.2,12338,18330,9.6,12236,315791,488210,15.7,70479,265182,411124,13.3,77086,165141,192419,5.6,4.7,26.6
1995,New Mexico,4.5,33996,479681,26717,4802,13.6,2615,3798,10.8,2603,54257,88253,18.4,14310,39874,66591,13.9,21662,29917,35712,7.1,5.6,27.8
1995,New York,1.4,354752,6616828,293126,47664,11.7,29371,41866,10.3,29255,642421,997173,15.1,160425,613554,906680,13.7,90493,350203,409210,5.4,4.4,27.4
1995,North Carolina,4.7,161002,2876894,110097,19740,12.4,9717,14259,8.9,9687,296803,457805,15.9,56778,212275,322372,11.2,135433,128770,161947,5.6,3.8,22.4
1995,North Dakota,4.4,10926,222130,8829,1745,9.8,949,1409,7.9,943,23266,34192,15.4,4808,15620,24449,11,9743,15221,17983,4.9,4,22
1995,Ohio,3.8,226608,4403850,162545,24995,10.6,12973,20059,8.5,12872,442464,669072,15.2,79237,337863,500408,11.4,168664,185483,236995,5.1,3.7,22.8
1995,Oklahoma,2.8,59557,1008427,51323,8568,11.9,5191,7291,10.1,5174,104536,164093,16.3,27134,84709,136032,13.5,28061,59817,72460,5.9,5.1,27
1995,Oregon,5.1,77017,1132074,53724,11212,14,5716,8514,10.6,5654,130604,207621,18.3,30651,96146,149870,13.2,57751,68413,81318,6.8,4.7,26.4
1995,Pennsylvania,2.8,225485,4570932,182141,25863,10.1,14219,21523,8.4,14146,429033,654518,14.3,91494,343312,525453,11.5,129065,206887,257102,4.9,4,23
1995,Rhode Island,3,19387,371131,14181,2669,11.1,1560,2273,9.4,1552,36049,55436,14.9,7546,29955,44136,11.9,11300,21548,24250,5.2,3.8,23.8
1995,South Carolina,3.9,82476,1342742,60129,9858,12.8,5177,7569,9.8,5147,134191,216667,16.1,30319,104070,164199,12.2,52468,62675,78274,6.1,4.5,24.4
1995,South Dakota,4.8,12469,258190,10350,2127,10.7,1164,1669,8.4,1163,26356,38825,15,5405,15888,26238,10.2,12587,17171,19969,4.8,4,20.4
1995,Tennessee,6.3,125622,2071888,82241,13707,12.4,7139,10474,9.5,7087,246907,372529,18,43354,160540,242781,11.7,129748,88817,111848,6.1,4,23.4
1995,Texas,4.8,477202,6437669,337018,51671,13.4,28005,41292,10.7,27732,760485,1237687,19.2,180751,589451,926469,14.4,311218,304034,389147,7.4,5.2,28.8
1995,Utah,6.5,54216,710460,33768,5943,15.5,2777,4039,10.6,2763,84917,139133,19.6,20254,59602,93370,13.1,45763,32474,39149,7.6,4.8,26.2
1995,Vermont,2.1,10775,219517,11567,1927,10.8,1140,1609,9,1139,21850,32625,14.9,6263,16453,28020,12.8,4605,15904,17980,4.9,5.3,25.6
1995,Virginia,4,144859,2385108,107636,17546,12.3,8755,13532,9.5,8710,250679,395538,16.6,49887,193756,301392,12.6,94146,113851,144500,6.1,4.5,25.2
1995,Washington,2.9,123155,1885068,97854,18020,13.8,10012,14691,11.3,9931,197005,320160,17,56470,168647,266501,14.1,53659,109793,131600,6.5,5.2,28.2
1995,West Virginia,3.8,29326,507859,24236,4161,11.5,2166,3257,9,2163,53046,82372,16.2,11015,38509,62745,12.4,19627,30050,36575,5.8,4.8,24.8
1995,Wisconsin,3.6,93956,2111438,70291,12225,10.4,6876,9979,8.5,6766,198418,292374,13.8,39606,145888,216179,10.2,76195,97668,118674,4.4,3.3,20.4
1995,Wyoming,3.1,10259,150101,7887,1802,12.4,956,1400,9.6,955,16076,26335,17.5,4198,13682,21569,14.4,4766,12678,14691,6.8,5.3,28.8
1996,Alabama,1.5,89766,1517840,72132,10721,12.4,6118,8773,10.1,6118,148711,238477,15.7,37078,142799,214931,14.2,23546,70247,87659,5.9,4.8,28.4
1996,Alaska,1.6,9714,175631,10869,1859,13,930,1522,10.7,930,20558,30272,17.2,4441,16471,27340,15.6,2932,12128,14441,5.5,6.2,31.2
1996,Arizona,5.4,115988,1519275,79970,13178,15,6652,9998,11.4,6651,180551,296539,19.5,43090,134880,214850,14.1,81689,72373,89522,7.6,5.3,28.2
1996,Arkansas,1.9,47090,882467,37309,6695,12.4,4007,5674,10.5,4006,84657,131747,14.9,21723,77648,114957,13,16790,45282,54317,5.3,4.2,26
1996,California,1.6,684629,10867543,671559,83444,12.8,48266,73535,11.3,48254,1252449,1937078,17.8,308558,1093867,1765426,16.2,171652,533916,656141,6.3,6.2,32.4
1996,Colorado,3.2,129590,1548413,103176,15075,14.6,7652,11757,11.4,7651,176133,305723,19.7,44769,152575,255751,16.5,49972,88173,104559,8.4,6.7,33
1996,Connecticut,1.3,81487,1403573,61224,8146,10,4853,7614,9.4,4852,122976,204463,14.6,28897,125981,187205,13.3,17258,69027,81409,5.8,4.4,26.6
1996,Delaware,0.1,18331,323605,17100,2211,12.1,1118,1854,10.1,1118,30013,48344,14.9,6933,30941,48041,14.8,303,15567,18533,5.7,5.3,29.6
1996,District of Columbia,-4.8,16730,397889,16806,1844,10.3,944,1689,9.5,944,31983,48713,12.2,5785,50678,67484,17,-18771,14897,17886,4.2,4.2,24.4
1996,Florida,2.9,423981,5192648,340929,49338,14.1,29228,42164,12.1,29226,600378,1024359,19.7,186712,533598,874527,16.8,149832,288960,352893,8.2,6.6,33.6
1996,Geogia,3,209521,2903831,174934,22432,14.1,11271,17505,11,11270,325793,535314,18.4,76178,271083,446017,15.4,89297,128308,161583,7.2,6,30.8
1996,Hawaii,-0.3,27470,422490,20565,2801,10.3,1776,2835,10.5,1776,33461,60931,14.4,9072,41744,62309,14.7,-1378,21499,27072,6.5,4.9,28.8
1996,Idaho,3.1,27110,373127,21906,4159,14.6,2126,3086,10.8,2126,42944,70054,18.8,12482,36708,58614,15.7,11440,24803,29029,7.3,5.9,31.4
1996,Illinois,1.1,262148,4902424,206542,28857,11,15941,25080,9.6,15940,465697,727845,14.8,93439,462873,669415,13.7,58430,215915,263187,5.3,4.2,27.4
1996,Indiana,0.4,128150,2376361,117631,14091,11,7965,12293,9.6,7964,217351,345501,14.5,48956,217864,335495,14.1,10006,102077,128389,5.4,5,28.2
1996,Iowa,2.5,56230,1124169,40846,6862,9.7,4023,6092,8.6,4022,100426,156656,13.9,20974,87028,127874,11.4,28782,57677,71152,5,3.6,22.8
1996,Kansas,3,57232,972447,44893,7189,11.3,4163,6071,9.5,4163,94785,152017,15.6,24401,77533,122426,12.6,29591,52766,64136,5.9,4.6,25.2
1996,Kentucky,1.4,83980,1335854,61280,8805,11.4,5145,7522,9.7,5145,121759,205739,15.4,31797,125458,186738,14,19001,62919,77957,6.3,4.6,28
1996,Louisiana,2.8,80314,1407156,62986,9777,11.2,5339,7860,9,5338,153351,233665,16.6,33637,130605,193591,13.8,40074,71286,88202,5.7,4.5,27.6
1996,Maine,0.8,22973,423512,18874,3807,12.3,2123,3033,9.8,2123,36101,59074,13.9,10892,36448,55322,13.1,3752,26748,31348,5.4,4.5,26.2
1996,Maryland,0.2,108941,1801753,96172,12346,11.4,7012,11091,10.3,7007,174636,283577,15.7,43985,182801,278973,15.5,4604,88572,108677,6,5.3,31
1996,Massachusetts,1.3,129224,2708174,135486,15313,10.7,8330,13184,9.2,8329,264650,393874,14.5,57694,221496,356982,13.2,36892,119062,143754,4.8,5,26.4
1996,Michigan,1,182944,3676047,149146,22098,11,11828,17827,8.9,11828,347334,530278,14.4,76617,342533,491679,13.4,38599,164295,203279,5,4.1,26.8
1996,Minnesota,1.9,109205,2070519,78954,12516,11.3,6269,9804,8.8,6267,191681,300886,14.5,41788,181526,260480,12.6,40406,92887,112583,5.3,3.8,25.2
1996,Mississippi,1.2,56494,853164,44819,6295,12.2,3705,5359,10.4,3705,78117,134611,15.8,22072,79631,124450,14.6,10161,42269,51929,6.6,5.3,29.2
1996,Missouri,1.9,122184,2158053,99682,14497,11.5,8556,12457,9.9,8556,211430,333614,15.5,48704,194741,294423,13.6,39191,103215,126733,5.7,4.6,27.2
1996,Montana,2.1,17483,258988,14290,3290,13.1,1746,2689,10.7,1746,24935,42418,16.4,8261,22675,36965,14.3,5453,22079,25378,6.8,5.5,28.6
1996,Nebraska,3.1,35437,671920,24978,4267,10.1,2617,3840,9.1,2617,62127,97564,14.5,13617,51307,76285,11.4,21279,35321,42573,5.3,3.7,22.8
1996,Nevada,6.2,65304,683539,41433,5563,17.1,2720,4067,12.5,2720,79290,144594,21.2,20800,61429,102862,15,41732,27947,33304,9.6,6.1,30
1996,New Hampshire,3.9,26268,468910,20026,3888,12.7,1940,2977,9.7,1939,48614,74882,16,10861,36939,56965,12.1,17917,26469,31128,5.6,4.3,24.2
1996,New Jersey,0.7,182341,3151479,163457,22753,11.7,13290,19861,10.3,13287,312443,494784,15.7,71341,308336,471793,15,22991,167550,194970,5.8,5.2,30
1996,New Mexico,2.7,34869,498067,27212,4822,13.3,2601,3798,10.5,2599,53847,88716,17.8,15775,48172,75384,15.1,13332,30569,36595,7,5.5,30.2
1996,New York,0.4,373628,6672472,331690,47794,11.6,30629,43931,10.7,30626,612938,986566,14.8,175177,628318,960008,14.4,26558,353159,412331,5.6,5,28.8
1996,North Carolina,1.7,171783,2975330,134547,20353,12.4,10141,15587,9.5,10141,280532,452315,15.2,62086,267280,401827,13.5,50488,132391,166207,5.8,4.5,27
1996,North Dakota,2,13684,230009,9598,1714,9.5,998,1511,8.4,998,20856,34540,15,4929,20403,30001,13,4539,15398,18162,5.9,4.2,26
1996,Ohio,1.8,241266,4536693,187870,24297,10.2,13665,21523,9,13662,428284,669550,14.8,83410,400188,588058,13,81492,187279,239476,5.3,4.1,26
1996,Oklahoma,3.5,73473,1041769,52203,8700,11.9,5283,7551,10.4,5280,103488,176961,17,28641,88802,141005,13.5,35956,60598,73469,7.1,5,27
1996,Oregon,4.6,79393,1189725,56339,11229,13.6,5879,8675,10.5,5877,135442,214835,18.1,32452,103916,160255,13.5,54580,70104,83597,6.7,4.7,27
1996,Pennsylvania,0.8,233472,4664500,205616,24959,9.7,15090,22908,8.9,15088,399887,633359,13.6,98212,390192,595808,12.8,37551,207805,258795,5,4.4,25.6
1996,Rhode Island,0.3,19028,377494,18446,2687,11,1664,2426,10,1662,31835,50863,13.5,9645,31416,49862,13.2,1001,21725,24464,5,4.9,26.4
1996,South Carolina,2.1,87719,1383948,62619,10219,12.9,5429,8056,10.2,5429,128894,216613,15.7,32535,125836,188455,13.6,28158,64103,80130,6.3,4.5,27.2
1996,South Dakota,1.4,15242,266747,12311,2219,11,1289,1888,9.4,1289,22214,37456,14,6352,21314,33625,12.6,3831,17448,20283,5.7,4.6,25.2
1996,Tennessee,0.5,133125,2143582,122873,14090,12.5,7663,11358,10,7659,196366,329491,15.4,69872,196857,319730,14.9,9761,90434,114345,6.2,5.7,29.8
1996,Texas,3.3,499314,6713351,377531,52207,13.3,28628,43281,11,28625,752897,1252211,18.7,186478,653692,1031223,15.4,220988,310610,397019,7.4,5.6,30.8
1996,Utah,5.1,58049,751213,35220,6375,15.9,2993,4355,10.9,2992,81901,139950,18.6,19996,66319,101539,13.5,38411,34162,41069,7.7,4.7,27
1996,Vermont,0.5,12615,222244,14947,1953,10.8,1214,1698,9.4,1214,19923,32538,14.6,6718,16391,31338,14.1,1200,16040,18169,5.7,6.7,28.2
1996,Virginia,1.3,145866,2449973,119459,17268,11.9,9331,14830,10.2,9331,240627,386493,15.8,50222,235516,354975,14.5,31518,115604,146732,6,4.9,29
1996,Washington,1.7,125297,1931829,97789,18622,14,10198,15532,11.7,10195,192651,317948,16.5,55214,187293,285082,14.8,32866,112031,134360,6.5,5.1,29.6
1996,West Virginia,0.2,31649,519318,24925,3968,10.8,2367,3532,9.6,2367,45044,76693,14.8,11766,51129,76054,14.6,639,30217,36895,6.1,4.8,29.2
1996,Wisconsin,1.4,96140,2168526,79881,12227,10.2,6949,10486,8.8,6943,182206,278346,12.8,38286,166572,246453,11.4,31893,98939,120286,4.4,3.7,22.8
1996,Wyoming,-0.9,9267,151556,7658,1891,12.7,1015,1511,10.2,1015,14171,23438,15.5,4342,17245,24903,16.4,-1465,13002,15027,6.1,5.1,31
1997,Alabama,0.9,99693,1537043,88397,11391,12.8,6363,9689,10.9,6363,161737,261430,17,41788,158811,247208,16.1,14222,71119,89421,6.5,5.8,32.2
1997,Alaska,3.1,12230,179388,9703,1988,13.6,970,1610,11,970,24310,36540,20.4,4416,21368,31071,17.3,5469,12384,14784,6.8,5.4,34.6
1997,Arizona,5.7,151056,1608847,118379,14962,16.3,7065,11406,12.5,7065,219607,370663,23,47498,160545,278924,17.3,91739,74812,93249,9.4,7.4,34.6
1997,Arkansas,2.3,55590,896806,44221,7014,12.8,4092,6040,11,4092,92835,148425,16.6,22299,84429,128650,14.3,19775,45623,55154,6.2,4.9,28.6
1997,California,3.3,822432,11151803,753272,90208,13.6,48558,81035,12.3,48557,1451680,2274112,20.4,342815,1158681,1911953,17.1,362159,541289,665108,7.4,6.8,34.2
1997,Colorado,3.5,142429,1601950,113297,16708,15.7,7956,12753,12,7956,194070,336499,21,50503,166611,279908,17.5,56591,90837,108371,8.9,7.1,35
1997,Connecticut,3,82514,1445493,76401,8854,10.8,5019,8331,10.2,5019,164359,246873,17.1,32797,127675,204076,14.1,42797,69113,81941,5.7,5.3,28.2
1997,Delaware,4.3,24659,330868,18795,2598,13.8,1159,2020,10.7,1159,37609,62268,18.8,7407,29169,47964,14.5,14304,15973,19154,7.5,5.7,29
1997,District of Columbia,0.3,18692,389370,21910,1933,10.8,1014,2035,11.4,1014,38139,56831,14.6,6393,33946,55856,14.3,975,14857,17806,4.8,5.6,28.6
1997,Florida,2.7,468512,5343300,405105,53317,14.9,30463,46047,12.9,30462,653941,1122453,21,199698,575103,980208,18.3,142245,292387,359980,8.8,7.6,36.6
1997,Geogia,2.4,228088,2983982,199995,23700,14.4,11964,19063,11.6,11964,357229,585317,19.6,97130,314080,514075,17.2,71242,131028,166115,7.6,6.7,34.4
1997,Hawaii,-0.2,20657,421474,20405,2915,10.8,1762,2937,10.9,1762,39794,60451,14.3,9598,40728,61133,14.5,-682,21466,27009,4.9,4.8,28.6
1997,Idaho,2.3,29531,383919,26317,4554,15.4,2260,3562,12,2260,44050,73581,19.2,11277,38382,64699,16.9,8882,25575,30023,7.7,6.9,33.8
1997,Illinois,1.7,283940,4978069,261677,30750,11.6,16572,27510,10.4,16572,524668,808608,16.2,112741,458481,720158,14.5,88450,217733,266291,5.7,5.3,29
1997,Indiana,2,135231,2408409,127676,15338,11.8,8274,13301,10.3,8274,254598,389829,16.2,54427,213913,341589,14.2,48240,102793,130432,5.6,5.3,28.4
1997,Iowa,1.1,59467,1146531,57950,7461,10.4,4155,6709,9.4,4155,113445,172912,15.1,26799,102506,160456,14,12456,57954,71920,5.2,5.1,28
1997,Kansas,3.6,68479,1005385,49444,7971,12.3,4203,6794,10.5,4203,106050,174529,17.4,24367,89182,138626,13.8,35903,53327,65272,6.8,4.9,27.6
1997,Kentucky,3,85042,1366187,72772,9655,12.3,5161,8237,10.5,5161,152875,237917,17.4,32270,124176,196948,14.4,40969,63608,79348,6.2,5.3,28.8
1997,Louisiana,2.1,93628,1445436,88544,10564,11.9,5749,9124,10.2,5749,170068,263696,18.2,36611,143525,232069,16.1,31627,72192,89720,6.5,6.1,32.2
1997,Maine,2.2,23415,430596,22538,3947,12.4,2075,3290,10.4,2075,43731,67146,15.6,11602,35254,57792,13.4,9354,27204,32013,5.4,5.2,26.8
1997,Maryland,3.5,132636,1837782,107704,13880,12.7,7307,12344,11.3,7307,219362,351998,19.2,43634,180215,287919,15.7,64079,89546,110313,7.2,5.9,31.4
1997,Massachusetts,2.8,168258,2767461,136230,16984,11.7,8285,13728,9.4,8285,296970,465228,16.8,59442,252446,388676,14,76552,121311,147093,6.1,4.9,28
1997,Michigan,2.4,217907,3743274,192929,23454,11.5,12533,20710,10.1,12533,421623,639530,17.1,80058,356911,549840,14.7,89690,166302,205977,5.8,5.2,29.4
1997,Minnesota,2.4,119717,2119083,114073,13881,12.2,6750,11250,9.9,6750,225056,344773,16.3,47812,181141,295214,13.9,49559,94571,115237,5.6,5.4,27.8
1997,Mississippi,2.5,53339,871930,43883,6596,12.6,3723,5618,10.7,3723,97939,151278,17.3,20389,85594,129477,14.8,21801,42810,52944,6.1,5,29.6
1997,Missouri,2.7,127305,2210438,114486,15038,11.8,9120,14111,11.1,9120,244724,372029,16.8,55995,196306,310792,14.1,61237,103505,127642,5.8,5.2,28.2
1997,Montana,1.4,18308,264252,16603,3473,13.5,1848,2783,10.8,1848,29107,47415,17.9,9171,26879,43482,16.5,3933,22631,26050,6.9,6.3,33
1997,Nebraska,0.9,41841,686399,32761,4730,11,2551,4103,9.6,2551,64937,106778,15.6,16260,68110,100871,14.7,5907,35809,43191,6.1,4.8,29.4
1997,Nevada,6.2,68348,727932,39432,6636,19.2,2816,4488,13,2816,89672,158020,21.7,18118,73427,112859,15.5,45161,29497,35507,9.4,5.4,31
1997,New Hampshire,2.2,28118,483945,25217,3979,12.6,2070,3306,10.5,2070,51962,80080,16.5,11713,43922,69139,14.3,10941,26990,31813,5.8,5.2,28.6
1997,New Jersey,3,212380,3211284,200003,25247,12.8,13559,21738,11,13559,389882,602262,18.8,80352,307646,507649,15.8,94613,170254,198247,6.6,6.2,31.6
1997,New Mexico,1.5,37901,509114,30249,5071,13.7,2831,4446,12,2831,57133,95034,18.7,14972,57439,87688,17.2,7346,30759,37189,7.4,5.9,34.4
1997,New York,1.5,387219,6749099,393546,51095,12.3,30732,46098,11.1,30732,743254,1130473,16.7,177608,630363,1023909,15.2,106564,356925,417265,5.7,5.8,30.4
1997,North Carolina,3.2,203133,3052055,156270,24068,14.2,10575,17075,10,10575,320757,523890,17.2,66103,270116,426386,14,97504,136584,173190,6.7,5.1,28
1997,North Dakota,4.4,13866,237454,13579,1770,9.8,1160,1840,10.2,1160,28843,42709,18,7735,18722,32301,13.6,10408,15261,18067,5.8,5.7,27.2
1997,Ohio,1.6,284352,4616927,238589,26985,11.2,14410,24451,10.1,14410,468340,752692,16.3,95574,440418,679007,14.7,73685,188525,242011,6.2,5.2,29.4
1997,Oklahoma,3.3,79651,1077618,59688,9811,13.2,5432,8300,11.2,5432,124475,204126,18.9,33877,108047,167735,15.6,36391,61285,74941,7.4,5.5,31.2
1997,Oregon,4.6,88290,1246464,71819,11683,13.8,6118,9680,11.4,6118,158197,246487,19.8,33245,117800,189619,15.2,56868,71390,85533,7.1,5.8,30.4
1997,Pennsylvania,1.6,257317,4730865,247271,28280,10.8,15063,24940,9.6,15063,484111,741428,15.7,110568,418234,665505,14.1,75923,209371,262288,5.4,5.2,28.2
1997,Rhode Island,2.6,22004,383505,17910,2736,11.1,1663,2452,10,1663,38727,60731,15.8,8942,32573,50483,13.2,10248,21985,24753,5.7,4.7,26.4
1997,South Carolina,2.6,97943,1418402,77787,11173,13.7,5520,8773,10.8,5520,149114,247057,17.4,36310,131568,209355,14.8,37702,65651,82583,6.9,5.5,29.6
1997,South Dakota,2.7,18240,272405,14291,2438,11.9,1352,2123,10.4,1352,26670,44910,16.5,6873,23171,37462,13.8,7448,17561,20549,6.7,5.2,27.6
1997,Tennessee,2.6,149410,2179189,116904,15087,13,8032,12678,10.9,8032,239893,389303,17.9,54704,216238,333142,15.3,56161,91591,116886,6.9,5.4,30.6
1997,Texas,3.7,568149,6966375,469026,55983,13.9,29979,47888,11.9,29979,882594,1450743,20.8,220929,720393,1189419,17.1,261324,314689,405103,8.2,6.7,34.2
1997,Utah,5.1,70363,793332,53433,6948,16.5,3170,4980,11.8,3170,96484,166847,21,22166,72552,125985,15.9,40862,35629,43022,8.9,6.7,31.8
1997,Vermont,2.7,16081,226081,11549,2117,11.5,1216,1805,9.8,1216,20099,36180,16,5982,18528,30077,13.3,6103,16269,18497,7.1,5.1,26.6
1997,Virginia,4.4,177066,2522571,134175,19450,13.1,9262,15724,10.6,9262,299428,476494,18.9,55667,232038,366213,14.5,110281,118049,150435,7,5.3,29
1997,Washington,2.4,149567,1975920,154617,19859,14.6,10333,16914,12.4,10332,246048,395615,20,59617,193429,348046,17.6,47569,113960,137179,7.6,7.8,35.2
1997,West Virginia,2,31147,524833,24040,4245,11.4,2378,3731,10,2378,53951,85098,16.2,12760,50617,74657,14.2,10441,30407,37396,5.9,4.6,28.4
1997,Wisconsin,2.2,119807,2210322,97464,13451,11.1,7013,11304,9.3,7013,208866,328673,14.9,40403,184060,281524,12.7,47149,100150,122451,5.4,4.4,25.4
1997,Wyoming,2,10729,151861,10058,1920,12.7,1049,1809,12,1049,18151,28880,19,4954,15765,25823,17,3057,13159,15076,7.1,6.6,34
1998,Alabama,1.2,89511,1554924,93003,10431,11.6,6666,9870,11,6666,158280,247791,15.9,38934,136108,229111,14.7,18680,71184,89772,5.8,6,29.4
1998,Alaska,4.4,13872,186202,9436,1987,13.3,1032,1675,11.2,1032,22494,36366,19.5,4616,18632,28068,15.1,8298,12574,15009,7.4,5.1,30.2
1998,Arizona,4.3,132954,1690810,113520,13306,14.2,7528,11412,12.1,7528,210402,343356,20.3,65412,157779,271299,16,72057,75861,94828,7.9,6.7,32
1998,Arkansas,2.3,59576,922751,51145,6505,11.8,4400,6327,11.5,4400,88234,147810,16,23580,75150,126295,13.7,21515,45392,55295,6.5,5.5,27.4
1998,California,4.6,830664,11551112,677762,87132,13,49757,76362,11.4,49757,1428229,2258893,19.6,331103,1057460,1735222,15,523671,547613,673732,7.2,5.9,30
1998,Colorado,5.4,133185,1675464,95993,16134,14.7,8438,12711,11.6,8438,206251,339436,20.3,48996,153522,249515,14.9,89921,92986,111498,7.9,5.7,29.8
1998,Connecticut,1.3,88146,1474336,72500,8390,10.2,5284,8255,10.1,5284,141531,229677,15.6,32961,138216,210716,14.3,18961,69005,81916,6,4.9,28.6
1998,Delaware,2.7,25315,342454,17460,2476,12.8,1244,2064,10.7,1244,36351,61666,18,8032,34794,52254,15.3,9412,16294,19518,7.4,5.1,30.6
1998,District of Columbia,2.2,18996,395209,15691,1789,10.1,968,1752,9.8,968,39210,58206,14.7,6749,33774,49465,12.5,8741,14773,17793,4.8,4,25
1998,Florida,4.1,425701,5517662,375164,49783,13.8,30924,46200,12.8,30924,687943,1113644,20.2,193097,515659,890823,16.1,222821,294299,362462,7.7,6.8,32.2
1998,Geogia,3,228036,3068552,194306,23294,13.9,12413,19507,11.6,12413,349875,577911,18.8,86293,291726,486032,15.8,91879,133252,169415,7.4,6.3,31.6
1998,Hawaii,-1.3,23996,418240,24639,2692,10,1795,2864,10.6,1795,34041,58037,13.9,9526,38952,63591,15.2,-5554,21380,26808,5.7,5.9,27.8
1998,Idaho,5.2,34475,398919,20750,4217,13.9,2376,3537,11.7,2376,45026,79501,19.9,11790,37708,58458,14.7,21043,26008,30632,8.6,5.2,29.4
1998,Illinois,2.8,269736,5089815,227499,28657,10.7,16454,25421,9.5,16454,533319,803055,15.8,110528,436180,663679,13,139376,219245,269011,5.3,4.5,26
1998,Indiana,2.5,136428,2462442,110912,13798,10.5,8262,12574,9.6,8262,235317,371745,15.1,51150,200286,311198,12.6,60547,103255,131429,5.5,4.5,25.2
1998,Iowa,3.5,55767,1171738,43844,6936,9.6,4134,6340,8.8,4134,114738,170505,14.6,22128,86207,130051,11.1,40454,58097,72351,4.8,3.7,22.2
1998,Kansas,3.3,65754,1040239,56748,7349,11.2,4382,6598,10.1,4382,109229,174983,16.8,26275,83873,140621,13.5,34362,53594,65851,6.3,5.5,27
1998,Kentucky,2.4,91628,1401123,66440,9195,11.5,5302,8019,10,5302,135752,227380,16.2,31200,127603,194043,13.8,33337,64136,80353,6.5,4.7,27.6
1998,Louisiana,3.3,95349,1486718,81380,10014,11.1,5922,9012,10,5922,170683,266032,17.9,42913,135918,217298,14.6,48734,72602,90443,6.4,5.5,29.2
1998,Maine,3.4,25821,442486,20213,3939,12.2,2176,3180,9.8,2176,41342,67163,15.2,11816,31991,52204,11.8,14959,27757,32679,5.8,4.6,23.6
1998,Maryland,2.4,126236,1899176,109612,12765,11.5,7393,11921,10.8,7393,199918,326154,17.2,50711,170620,280232,14.8,45922,89974,110917,6.6,5.8,29.6
1998,Massachusetts,2.3,150811,2835988,127174,15650,10.6,8862,13772,9.3,8862,299093,449904,15.9,58658,257949,385123,13.6,64781,122544,148564,5.3,4.5,27.2
1998,Michigan,2.4,213553,3828325,173595,21766,10.5,13239,20270,9.8,13239,384860,598413,15.6,85747,329906,503501,13.2,94912,166559,206886,5.6,4.5,26.4
1998,Minnesota,4.4,121108,2188697,90982,12907,11.1,6719,10414,9,6719,243493,364601,16.7,47498,178767,269749,12.3,94852,96430,117421,5.5,4.2,24.6
1998,Mississippi,2.6,49299,892900,43591,6171,11.6,3917,5662,10.7,3917,89143,138442,15.5,23430,71305,114896,12.9,23546,42886,53305,5.5,4.9,25.8
1998,Missouri,1.5,130708,2254889,100323,14381,11.2,8883,13298,10.4,8883,205530,336238,14.9,49293,202754,303077,13.4,33161,103817,128458,5.8,4.4,26.8
1998,Montana,2.5,19901,268743,16851,3486,13.3,2008,2913,11.1,2008,27076,46977,17.5,8423,23420,40271,15,6706,23024,26521,7.4,6.3,30
1998,Nebraska,2.6,37276,696092,31147,4414,10.2,2686,4016,9.3,2686,65434,102710,14.8,14163,53970,85117,12.2,17593,35905,43466,5.4,4.5,24.4
1998,Nevada,4.1,61515,764278,37410,6385,17.5,3007,4489,12.3,3007,81555,143070,18.7,19472,74394,111804,14.6,31266,30787,37285,8,4.9,29.2
1998,New Hampshire,3.7,27523,498116,24717,3713,11.6,2052,3157,9.9,2052,54858,82381,16.5,13096,39223,63940,12.8,18441,27495,32267,5.5,5,25.6
1998,New Jersey,2.2,210852,3295447,184852,23810,11.9,13932,20852,10.5,13932,362286,573138,17.4,81505,314973,499825,15.2,73313,172256,200653,6.4,5.6,30.4
1998,New Mexico,2.1,40376,515866,33167,4630,12.4,2760,4259,11.4,2760,52605,92981,18,16871,48818,81985,15.9,10996,30913,37432,7.8,6.4,31.8
1998,New York,2.2,393513,6874662,347613,48687,11.6,30537,43666,10.4,30537,764792,1158305,16.8,173389,655456,1003069,14.6,155236,360277,421540,5.7,5.1,29.2
1998,North Carolina,2.8,203990,3142561,169489,22052,12.6,11664,18873,10.8,11661,308825,512815,16.3,69864,255722,425211,13.5,87604,139048,175959,6.5,5.4,27
1998,North Dakota,0.7,13698,243173,12838,1729,9.6,1089,1672,9.2,1089,24152,37850,15.6,6932,23384,36222,14.9,1628,15285,18087,5.6,5.3,29.8
1998,Ohio,2.2,237168,4700175,225602,24019,9.9,14181,22509,9.3,14180,482588,719756,15.3,96181,391760,617362,13.1,102394,189006,243121,5,4.8,26.2
1998,Oklahoma,3.9,72780,1116702,61562,8838,11.8,5495,8140,10.8,5493,124029,196809,17.6,31861,90881,152443,13.7,44366,61526,75425,6.5,5.5,27.4
1998,Oregon,1.5,81653,1282318,73423,10813,12.6,6227,9636,11.2,6227,133865,215518,16.8,36199,123253,196676,15.3,18842,72173,86408,6.4,5.7,30.6
1998,Pennsylvania,1.8,243869,4813369,215323,25903,9.8,15122,23701,9,15122,459677,703546,14.6,96346,399652,614975,12.8,88571,210232,263993,5.1,4.5,25.6
1998,Rhode Island,2.8,21656,394558,16013,2612,10.5,1647,2413,9.7,1647,38483,60139,15.2,8192,32892,48905,12.4,11234,22163,24910,5.5,4.1,24.8
1998,South Carolina,3.8,105149,1464809,79927,10586,12.7,5845,8908,10.7,5845,152210,257359,17.6,34496,121500,201427,13.8,55932,66821,84107,7.2,5.5,27.6
1998,South Dakota,3.7,14737,280509,12779,2257,11,1418,2068,10,1418,28566,43303,15.4,7088,20023,32802,11.7,10501,17648,20654,5.3,4.6,23.4
1998,Tennessee,3,146707,2239565,111233,13943,11.9,8398,12658,10.8,8397,225499,372206,16.6,54404,193092,304325,13.6,67881,91610,117770,6.6,5,27.2
1998,Texas,4.1,546107,7246952,428169,52894,13,29937,46290,11.4,29933,884756,1430863,19.7,216355,702429,1130598,15.6,300265,317825,410599,7.5,5.9,31.2
1998,Utah,3,67591,824763,44982,6550,15,3433,5175,11.9,3433,93926,161517,19.6,23593,91942,136924,16.6,24593,36535,44197,8.2,5.5,33.2
1998,Vermont,3.1,11993,233354,10672,1914,10.4,1284,1887,10.2,1284,22978,34971,15,5674,17192,27864,11.9,7107,16311,18481,5.1,4.6,23.8
1998,Virginia,2.6,168817,2610099,140033,18526,12.2,9646,15638,10.3,9646,265849,434666,16.7,59450,229030,369063,14.1,65603,119595,152958,6.5,5.4,28.2
1998,Washington,3.7,131928,2034268,108103,18713,13.5,10440,15809,11.4,10440,236521,368449,18.1,55971,185027,293130,14.4,75319,115841,139701,6.5,5.3,28.8
1998,West Virginia,1.2,30728,534253,24515,3779,10.1,2407,3571,9.5,2407,49841,80569,15.1,12495,49851,74366,13.9,6203,30398,37532,5.8,4.6,27.8
1998,Wisconsin,2.6,109426,2263122,88281,12185,9.9,7171,10871,8.8,7171,210463,319889,14.1,42406,172484,260765,11.5,59124,100895,123469,4.8,3.9,23
1998,Wyoming,1.9,12203,155229,10787,1931,12.7,1073,1615,10.6,1073,16314,28517,18.4,5824,14880,25667,16.5,2850,13389,15391,7.9,6.9,33
1999,Alabama,1.8,107222,1592218,84307,10252,11.4,6393,9540,10.6,6393,152194,259416,16.3,39765,146048,230355,14.5,29061,71205,90344,6.7,5.3,29
1999,Alaska,0.7,10726,192105,9269,1780,11.8,1026,1616,10.7,1026,19570,30296,15.8,4472,19800,29069,15.1,1227,12622,15134,5.6,4.8,30.2
1999,Arizona,4.3,149166,1764631,114089,14051,14.6,7293,11555,12,7293,210290,359456,20.4,56325,169875,283964,16.1,75492,77311,97254,8.5,6.5,32.2
1999,Arkansas,1.4,53021,942752,52463,6495,11.7,4172,6159,11.1,4172,93175,146196,15.5,23722,80909,133372,14.1,12824,45341,55562,5.6,5.6,28.2
1999,California,2.4,847713,11990313,756156,87519,12.9,48337,76825,11.3,48337,1387381,2235094,18.6,340217,1185775,1941931,16.2,293163,554863,683714,7.1,6.3,32.4
1999,Colorado,3.8,143998,1759199,115974,16109,14.3,8335,12971,11.5,8335,204585,348583,19.8,50944,165352,281326,16,67257,95003,114449,8.2,6.6,32
1999,Connecticut,2.1,80295,1499805,73256,8038,9.8,5050,7811,9.5,5050,148387,228682,15.2,30806,123061,196317,13.1,32365,68663,82063,5.4,4.9,26.2
1999,Delaware,0.6,22718,348206,18584,2489,12.6,1182,2050,10.4,1182,31639,54357,15.6,7526,33731,52315,15,2042,16662,19938,6.5,5.3,30
1999,District of Columbia,1.7,21680,403311,20106,1800,10.1,933,1756,9.9,933,37867,59547,14.8,6353,32621,52727,13.1,6820,14733,17835,5.4,5,26.2
1999,Florida,3.8,436562,5742642,429447,51234,14,30396,45649,12.5,30396,771132,1207694,21,193480,556381,985828,17.2,221866,296539,367234,7.6,7.5,34.4
1999,Geogia,5.1,249748,3214638,189420,22852,13.4,12198,19306,11.3,12198,384013,633761,19.7,82646,279479,468899,14.6,164862,135585,172753,7.8,5.9,29.2
1999,Hawaii,0.1,25382,415078,21172,2545,9.5,1695,2696,10.1,1695,33866,59248,14.3,10249,37601,58773,14.2,475,21205,26591,6.1,5.1,28.4
1999,Idaho,3.3,30248,422144,24069,4363,14,2254,3346,10.7,2254,43086,73334,17.4,12893,35293,59362,14.1,13972,26590,31613,7.2,5.7,28.2
1999,Illinois,2.1,275854,5212988,238450,27980,10.4,16158,25848,9.6,16158,512388,788242,15.1,98406,437828,676278,13,111964,219961,271020,5.3,4.6,26
1999,Indiana,1.8,126738,2532484,110027,13249,10.1,8237,12534,9.5,8237,242865,369603,14.6,54103,213089,323116,12.8,46487,103095,132072,5,4.3,25.6
1999,Iowa,2.2,63199,1214396,49929,6713,9.3,4219,6387,8.8,4219,109915,173114,14.3,22359,96473,146402,12.1,26712,57954,72615,5.2,4.1,24.2
1999,Kansas,2.9,67247,1079168,59854,7020,10.6,4280,6652,10.1,4280,110963,178210,16.5,26864,86907,146761,13.6,31449,53670,66226,6.2,5.5,27.2
1999,Kentucky,1.1,85017,1429750,69004,8762,10.9,5350,8051,10,5350,131393,216410,15.1,31284,130736,199740,14,16670,64218,80979,5.9,4.8,28
1999,Louisiana,0.5,88905,1544149,90099,9509,10.5,5897,9032,10,5897,156234,245139,15.9,45762,146984,237083,15.4,8056,72517,90939,5.8,5.8,30.8
1999,Maine,3,25691,458062,19499,3879,11.7,2080,3154,9.5,2080,44964,70655,15.4,11386,37354,56853,12.4,13802,28318,33386,5.6,4.3,24.8
1999,Maryland,1.4,125198,1937473,122557,12499,11.2,6943,11412,10.2,6943,204580,329778,17,56037,179533,302090,15.6,27688,90551,111811,6.5,6.3,31.2
1999,Massachusetts,2.3,168681,2905949,141714,15144,10.2,8808,13970,9.4,8808,300248,468929,16.1,60529,258581,400295,13.8,68634,123189,149587,5.8,4.9,27.6
1999,Michigan,1.5,226804,3915129,184135,21016,10.1,12782,19718,9.5,12782,380920,607724,15.5,88597,365677,549812,14,57912,166542,208019,5.8,4.7,28
1999,Minnesota,2.8,134263,2280605,106373,12920,10.9,6612,10751,9.1,6612,216286,350549,15.4,42182,180709,287082,12.6,63467,97772,119533,5.9,4.7,25.2
1999,Mississippi,1.9,51988,931169,49117,6159,11.5,3933,5731,10.7,3933,93214,145202,15.6,23661,78821,127938,13.7,17264,42998,53712,5.6,5.3,27.4
1999,Missouri,2.2,132178,2303360,114111,14192,11,8803,13269,10.3,8803,227370,359548,15.6,46197,194106,308217,13.4,51331,103901,129299,5.7,5,26.8
1999,Montana,3.9,18611,277953,14891,3208,12,1916,2825,10.6,1916,29973,48584,17.5,8314,22796,37687,13.6,10897,23241,26848,6.7,5.4,27.2
1999,Nebraska,3,43096,718369,36320,4205,9.6,2582,3961,9.1,2582,69435,112531,15.7,19709,55191,91511,12.7,21020,36010,43713,6,5.1,25.4
1999,Nevada,7,76118,813262,42907,6935,18.1,3081,4704,12.3,3081,97184,173302,21.3,22686,73476,116383,14.3,56919,32240,39498,9.4,5.3,28.6
1999,New Hampshire,2.8,27158,514173,19646,3544,10.9,2016,3005,9.2,2016,47176,74334,14.5,10729,40682,60328,11.7,14006,27757,32782,5.3,3.8,23.4
1999,New Jersey,2.2,213169,3369725,171103,22557,11.2,13880,20848,10.4,13880,346243,559412,16.6,81840,312477,483580,14.4,75832,172977,202065,6.3,5.1,28.8
1999,New Mexico,1.2,38186,532112,29712,4622,12.3,2794,4290,11.4,2794,51614,89800,16.9,15035,54065,83777,15.7,6023,30830,37743,7.2,5.6,31.4
1999,New York,1.6,400354,7013892,356672,47236,11.2,30114,43322,10.2,30114,682833,1083187,15.4,179703,612157,968829,13.8,114358,361153,424942,5.7,5.1,27.6
1999,North Carolina,2.7,214293,3238145,179076,21750,12.2,11522,18065,10.2,11522,339345,553638,17.1,81747,288499,467575,14.4,86063,141395,179380,6.6,5.5,28.8
1999,North Dakota,0.5,12767,246400,10582,1530,8.5,1008,1526,8.4,1008,19977,32744,13.3,5066,20923,31505,12.8,1239,15225,18087,5.2,4.3,25.6
1999,Ohio,1.1,245007,4785467,221287,23293,9.6,13713,21883,9,13713,445735,690742,14.4,88451,416330,637617,13.3,53125,188850,244231,5.1,4.6,26.6
1999,Oklahoma,0.8,75665,1150040,70195,8733,11.6,5431,8302,11,5431,118644,194309,16.9,32643,114404,184599,16.1,9710,61424,75635,6.6,6.1,32.2
1999,Oregon,1.5,81491,1300624,78952,10709,12.3,6323,9631,11.1,6323,133803,215294,16.6,35739,117727,196679,15.1,18615,72476,87338,6.3,6.1,30.2
1999,Pennsylvania,1,242211,4884235,217038,25039,9.5,15129,23901,9,15129,446295,688506,14.1,97338,420574,637612,13.1,50894,210279,264930,5,4.4,26.2
1999,Rhode Island,0.7,18030,401157,18180,2521,10.1,1724,2423,9.7,1724,37923,55953,13.9,8506,34681,52861,13.2,3092,22068,24983,4.5,4.5,26.4
1999,South Carolina,2.7,95047,1519624,70839,10757,12.7,5701,8885,10.5,5701,153470,248517,16.4,34117,137798,208637,13.7,39880,68153,85886,6.3,4.7,27.4
1999,South Dakota,2,16727,288703,13015,2208,10.6,1362,2010,9.7,1362,24186,40913,14.2,6365,22299,35314,12.2,5599,17726,20844,5.8,4.5,24.4
1999,Tennessee,1.1,144145,2294827,130765,13494,11.4,8258,12875,10.9,8258,224958,369103,16.1,51251,212685,343450,15,25653,91282,118281,6.3,5.7,30
1999,Texas,2.2,560733,7534968,508298,52078,12.6,30473,47181,11.4,30473,879583,1440316,19.1,223962,764995,1273293,16.9,167023,318388,415081,7.4,6.7,33.8
1999,Utah,2.7,64845,863060,52965,7080,15.7,3525,5307,11.8,3525,90210,155055,18,28090,79114,132079,15.3,22976,37559,45911,7.5,6.1,30.6
1999,Vermont,2.8,12401,240470,9687,1904,10.2,1154,1638,8.8,1154,21749,34150,14.2,6686,17615,27302,11.4,6848,16411,18748,5.2,4,22.8
1999,Virginia,2.9,166222,2698619,134828,17561,11.4,9631,15931,10.4,9631,283013,449235,16.6,55953,234030,368858,13.7,80377,120352,154389,6.2,5,27.4
1999,Washington,3.1,152182,2110334,119158,18314,13,10666,16507,11.8,10666,226804,378986,18,61026,195110,314268,14.9,64718,116654,141204,7.2,5.6,29.8
1999,West Virginia,-0.5,28146,537918,26922,3732,9.9,2414,3739,10,2414,44648,72794,13.5,12191,48472,75394,14,-2600,30313,37514,5.2,5,27
1999,Wisconsin,1.8,104737,2312929,93640,11985,9.7,7139,10896,8.8,7139,211326,316063,13.7,43716,181804,275444,11.9,40619,101193,124456,4.5,4,23.8
1999,Wyoming,3,10837,162778,9887,1839,11.9,1162,1733,11.2,1162,18979,29816,18.3,5243,15060,24947,15.3,4869,13373,15481,6.7,6.1,30.6
2000,Alabama,2.2,85796,1624678,85137,9581,10.6,6308,9904,11,6308,173985,259781,16,37525,139121,224258,13.8,35523,70588,90084,5.3,5.2,27.6
2000,Alaska,4.7,16014,197752,14195,1846,12.2,1011,1848,12.2,1011,24663,40677,20.6,5382,17324,31519,15.9,9158,12622,15150,8.1,7.2,31.8
2000,Arizona,4.7,155321,1847766,110757,13712,14,7340,11979,12.2,7340,227451,382772,20.7,48971,184900,295657,16,87115,77985,98974,8.4,6,32
2000,Arkansas,4,55759,966824,44730,6155,11.1,3935,6262,11.3,3935,101225,156984,16.2,21571,73193,117923,12.2,39061,44950,55464,5.8,4.6,24.4
2000,California,4.2,894539,12366627,774376,87448,12.7,47652,77832,11.3,47652,1544689,2439228,19.7,340240,1145153,1919529,15.5,519699,561944,693690,7.2,6.3,31
2000,Colorado,4.7,140127,1837443,108068,15957,13.8,8226,13664,11.8,8226,221235,361362,19.7,49185,167981,276049,15,85313,96551,116723,7.6,5.9,30
2000,Connecticut,1.1,77789,1526209,73822,7922,9.6,4762,7851,9.6,4762,145399,223188,14.6,25714,131604,205426,13.5,17762,68709,82209,5.1,4.8,27
2000,Delaware,5.5,32287,359767,19580,2678,13.3,1212,2146,10.6,1212,38304,70591,19.6,7039,31126,50706,14.1,19885,17020,20483,9,5.4,28.2
2000,District of Columbia,3.4,22888,413452,14160,1767,9.9,859,1647,9.2,859,40716,63604,15.4,6148,35395,49555,12,14049,14742,17959,5.5,3.4,24
2000,Florida,4.4,475633,6014073,433188,49447,13.4,29723,47516,12.9,29723,768739,1244372,20.7,201669,546440,979628,16.3,264744,296984,369079,7.9,7.2,32.6
2000,Geogia,3,242657,3355840,215194,22990,13.2,12378,20683,11.9,12378,382836,625493,18.6,79942,307244,522438,15.6,103055,136525,175134,7.2,6.4,31.2
2000,Hawaii,3.7,23476,422616,20650,2660,10,1497,2506,9.4,1497,39567,63043,14.9,8548,26570,47220,11.2,15823,21406,26777,5.6,4.9,22.4
2000,Idaho,3.2,33796,436045,24122,4129,13,2305,3780,11.9,2305,46461,80257,18.4,12297,42303,66425,15.2,13832,26837,31990,7.8,5.5,30.4
2000,Illinois,2.6,294167,5335814,276346,28274,10.4,16054,26957,9.9,16054,575029,869196,16.3,109843,456376,732722,13.7,136474,220130,272309,5.5,5.2,27.4
2000,Indiana,3,137739,2593040,117693,13046,9.9,8024,13309,10.1,8024,258759,396498,15.3,52546,201487,319180,12.3,77318,102577,131892,5.3,4.5,24.6
2000,Iowa,3.7,66168,1250147,51686,6598,9.1,4074,6606,9.1,4074,123192,189360,15.1,22480,90989,142675,11.4,46685,57722,72646,5.3,4.1,22.8
2000,Kansas,2,72320,1102222,57297,7061,10.6,4153,6821,10.3,4153,104853,177173,16.1,23088,98538,155835,14.1,21338,53560,66493,6.6,5.2,28.2
2000,Kentucky,3.4,89655,1477266,69323,8477,10.5,5232,8287,10.2,5232,147159,236814,16,34675,117096,186419,12.6,50395,63907,81160,6.1,4.7,25.2
2000,Louisiana,1.4,107273,1559029,91470,9531,10.5,5824,9645,10.6,5824,157401,264674,17,48243,152294,243764,15.6,20910,71934,90889,6.9,5.9,31.2
2000,Maine,4.5,29762,474378,21671,3711,11,2100,3242,9.6,2100,47086,76848,16.2,11040,33833,55504,11.7,21344,28597,33840,6.3,4.6,23.4
2000,Maryland,3.9,125096,1990097,106745,12331,11,6837,11662,10.4,6837,230097,355193,17.8,42113,169706,276451,13.9,78742,90656,112476,6.3,5.4,27.8
2000,Massachusetts,3.2,168645,2982428,153432,15613,10.4,8535,14090,9.4,8535,335200,503845,16.9,58687,255478,408910,13.7,94935,124069,151194,5.7,5.1,27.4
2000,Michigan,1.8,220770,3979100,221115,21112,10.1,12093,20624,9.9,12093,416183,636953,16,84037,345056,566171,14.2,70782,166749,208597,5.5,5.6,28.4
2000,Minnesota,3.1,119204,2349577,93738,12525,10.4,6648,11080,9.2,6648,242571,361775,15.4,44254,195736,289474,12.3,72301,98618,121016,5.1,4,24.6
2000,Mississippi,0.9,51636,942438,46387,5870,10.9,3804,5940,11.1,3804,84958,136594,14.5,21377,81401,127788,13.6,8806,42462,53669,5.5,4.9,27.2
2000,Missouri,1.8,134026,2349679,115017,14137,10.9,8618,13673,10.6,8618,235434,369460,15.7,49124,210715,325732,13.9,43728,103797,129790,5.7,4.9,27.8
2000,Montana,3.9,18903,288981,14862,3293,12.2,1913,2934,10.9,1913,31251,50154,17.4,8158,24174,39036,13.5,11118,23416,27189,6.5,5.1,27
2000,Nebraska,2.5,43806,741038,34325,4361,9.9,2406,3984,9.1,2406,69246,113052,15.3,16953,60867,95192,12.8,17860,36078,44077,5.9,4.6,25.6
2000,Nevada,6.4,72114,869240,47467,6641,16.6,3312,5357,13.4,3312,107584,179698,20.7,22549,76933,124400,14.3,55298,33092,40749,8.3,5.5,28.6
2000,New Hampshire,3.6,29436,530530,24178,3503,10.6,1970,3216,9.8,1970,56423,85859,16.2,11231,42588,66766,12.6,19093,27967,33131,5.5,4.6,25.2
2000,New Jersey,2.9,211730,3456600,197798,22814,11.2,13449,21309,10.5,13449,395620,607350,17.6,81044,312000,509798,14.7,97552,173288,203567,6.1,5.7,29.4
2000,New Mexico,1.5,38027,538049,34766,4468,11.8,2733,4490,11.9,2733,55698,93725,17.4,16434,50624,85390,15.9,8335,30581,37730,7.1,6.5,31.8
2000,New York,3.1,419092,7178005,368817,47749,11.2,28531,43678,10.2,28531,760737,1179829,16.4,170748,589360,958177,13.3,221652,363018,429059,5.8,5.1,26.6
2000,North Carolina,2.4,197335,3317681,171957,20557,11.4,11751,19148,10.6,11751,337201,534536,16.1,71637,281090,453047,13.7,81489,141638,180802,5.9,5.2,27.4
2000,North Dakota,2.6,13132,250353,10451,1559,8.6,1069,1616,9,1069,23070,36202,14.5,6045,19401,29852,11.9,6350,15073,18027,5.2,4.2,23.8
2000,Ohio,3.2,265036,4892725,221113,23147,9.5,13556,22688,9.3,13556,515549,780585,16,86956,405434,626547,12.8,154038,188238,244720,5.4,4.5,25.6
2000,Oklahoma,3.2,79704,1175489,62834,8310,11,5234,8395,11.1,5234,124195,203899,17.3,28906,102876,165710,14.1,38189,61070,75646,6.8,5.3,28.2
2000,Oregon,1.5,84082,1324924,77120,10014,11.5,6119,9974,11.4,6119,134339,218421,16.5,33199,121255,198375,15,20046,72295,87439,6.3,5.8,30
2000,Pennsylvania,2.8,291054,4971087,223589,25125,9.5,14498,23948,9,14498,484036,775090,15.6,88698,414005,637594,12.8,137496,210447,266137,5.9,4.5,25.6
2000,Rhode Island,1.6,26429,404722,26340,2531,10.1,1542,2382,9.5,1542,41319,67748,16.7,11528,34913,61253,15.1,6495,22084,25111,6.5,6.5,30.2
2000,South Carolina,2.8,93014,1560666,82786,10080,11.7,5812,9404,10.9,5812,164917,257931,16.5,35450,130987,213773,13.7,44158,68344,86570,6,5.3,27.4
2000,South Dakota,3.1,16498,295618,14169,2095,10,1291,2007,9.6,1291,30472,46970,15.9,7058,23774,37943,12.8,9027,17762,20926,5.6,4.8,25.6
2000,Tennessee,2.8,150201,2339128,134809,13103,11.1,7948,13163,11.1,7948,257480,407681,17.4,49047,206620,341429,14.6,66252,90450,118294,6.4,5.8,29.2
2000,Texas,3.5,569578,7749247,501574,51003,12.3,29168,48855,11.7,29168,934813,1504391,19.4,208499,729102,1230676,15.9,273715,318595,417447,7.4,6.5,31.8
2000,Utah,3.4,61972,889847,48409,6721,14.5,3487,5515,11.9,3487,100103,162075,18.2,24343,82996,131405,14.8,30670,38193,47093,7,5.4,29.6
2000,Vermont,3.6,13189,248029,10256,1834,9.7,1083,1662,8.8,1083,24933,38122,15.4,5465,19051,29307,11.8,8815,16515,18914,5.3,4.1,23.6
2000,Virginia,4.2,184840,2788993,151059,17668,11.4,9327,15947,10.3,9327,316851,501691,18,51568,232887,383946,13.8,117745,121162,156036,6.6,5.4,27.6
2000,Washington,3.8,149129,2184773,119376,17470,12.3,10384,16919,12,10371,253841,402970,18.4,54359,200095,319471,14.6,83499,116764,141812,6.8,5.5,29.2
2000,West Virginia,2.8,31153,544619,23560,3640,9.7,2293,3724,9.9,2293,50771,81924,15,12137,42979,66539,12.2,15385,30005,37408,5.7,4.3,24.4
2000,Wisconsin,2.4,115863,2362182,95370,12136,9.7,7020,11169,8.9,7020,216019,331882,14,40792,177840,273210,11.6,58672,101223,125363,4.9,4,23.2
2000,Wyoming,3.8,11519,168352,9230,1838,11.8,1047,1634,10.5,1047,18951,30470,18.1,4695,14763,23993,14.3,6477,13540,15699,6.8,5.5,28.6
2001,Alabama,-2.9,85494,1626673,92066,9527,10.6,6199,10346,11.5,6197,135013,220507,13.6,42560,175826,267892,16.5,-47385,69944,90025,5.3,5.7,27.2
2001,Alaska,3.6,13591,208374,11250,1864,12.2,972,1832,12,972,24478,38069,18.3,5256,19408,30658,14.7,7411,12678,15343,6.5,5.4,29.4
2001,Arizona,2.2,161875,1918356,128137,14262,14.2,7098,12434,12.4,7096,211901,373776,19.5,49511,204400,332537,17.3,41239,79694,101651,8.4,6.7,34.6
2001,Arkansas,-0.6,50733,986697,48306,6273,11.2,3835,6248,11.2,3834,89320,140053,14.2,21105,98022,146328,14.8,-6275,45032,56033,5.1,4.9,28.4
2001,California,2.4,880161,12853482,764787,91153,13,49652,82934,11.8,49615,1488457,2368618,18.4,338175,1287917,2052704,16,315914,571399,708631,6.8,6,32
2001,Colorado,3.4,154115,1922140,123560,16889,14.2,8455,14312,12.1,8451,231295,385410,20.1,51653,198177,321737,16.7,63673,98877,120300,8,6.4,33.4
2001,Connecticut,0.9,85479,1552569,78042,8123,9.8,4757,8104,9.8,4756,142837,228316,14.7,27516,135598,213640,13.8,14676,68662,82835,5.5,5,27.6
2001,Delaware,2.2,21544,375393,17766,2586,12.4,1229,2183,10.5,1228,40364,61908,16.5,8366,35913,53679,14.3,8229,17461,21158,5.7,4.7,28.6
2001,District of Columbia,1.2,25164,426146,21303,1851,10.2,836,1708,9.4,834,39639,64803,15.2,5526,38360,59663,14,5140,14935,18263,5.9,5,28
2001,Florida,3.8,495122,6314237,404388,52274,14,28352,47309,12.7,28334,819132,1314254,20.8,174434,671275,1075663,17,238591,302106,377249,7.8,6.4,34
2001,Geogia,0.2,235825,3422997,198115,23108,13.1,12065,21280,12,12062,331508,567333,16.6,81194,362493,560608,16.4,6725,138392,178374,6.9,5.8,32.8
2001,Hawaii,3.1,29171,442622,20825,2842,10.5,1432,2514,9.3,1430,38982,68153,15.4,10292,33609,54434,12.3,13719,21797,27349,6.6,4.7,24.6
2001,Idaho,4.4,39078,454862,26492,4375,13.5,2281,4205,13,2280,49432,88510,19.5,12995,42377,68869,15.1,19641,27210,32501,8.6,5.8,30.2
2001,Illinois,-0.8,286198,5404861,264824,27505,10.1,16113,27609,10.1,16091,482394,768592,14.2,103056,548408,813232,15,-44640,220398,274076,5.3,4.9,28.4
2001,Indiana,-2,127014,2615485,130406,13111,9.9,7884,13701,10.4,7875,223587,350601,13.4,53717,271935,402341,15.4,-51740,102294,132320,4.9,5,26.8
2001,Iowa,-2.5,55946,1263210,50672,6332,8.7,4091,7083,9.7,4090,93812,149758,11.9,22318,130937,181609,14.4,-31851,57289,72582,4.4,4,23.8
2001,Kansas,-1.2,58989,1111170,55899,6975,10.4,4206,7139,10.7,4205,90598,149587,13.5,25623,107686,163585,14.7,-13998,53619,66947,5.3,5,27
2001,Kentucky,-0.9,73634,1503542,75444,8280,10.2,4986,8462,10.4,4979,132060,205694,13.7,30972,144557,220001,14.6,-14307,64049,81568,4.9,5,27.4
2001,Louisiana,0,93278,1578606,82348,9496,10.4,5566,9722,10.6,5564,152184,245462,15.5,35934,162727,245075,15.5,387,72179,91480,5.9,5.2,31
2001,Maine,1.2,28614,489722,21764,3818,11.2,2120,3456,10.1,2117,41961,70575,14.4,10394,42741,64505,13.2,6070,28946,34493,5.8,4.4,26.4
2001,Maryland,1.8,126399,2056774,106544,12957,11.4,6550,11858,10.4,6544,201457,327856,15.9,45878,183987,290531,14.1,37325,92068,114470,6.1,5.2,28.2
2001,Massachusetts,1.4,160205,3065034,147087,15856,10.3,8725,14960,9.7,8721,319255,479460,15.6,66905,288255,435342,14.2,44118,126708,154531,5.2,4.8,28.4
2001,Michigan,-1.4,228113,3998139,217635,21307,10.2,12489,21735,10.4,12482,367891,596004,14.9,87752,433380,651015,16.3,-55011,166342,209731,5.7,5.4,29.8
2001,Minnesota,0.4,135742,2399005,111451,13694,11.2,6687,11798,9.6,6682,207837,343579,14.3,46186,221727,333178,13.9,10401,99939,123789,5.7,4.6,27.8
2001,Mississippi,-3.4,47808,935461,53983,5734,10.7,3753,6364,11.9,3753,76493,124301,13.3,21882,102643,156626,16.7,-32325,42100,53495,5.1,5.8,26.6
2001,Missouri,0.1,127103,2382147,113734,13378,10.3,8461,13917,10.7,8459,215670,342773,14.4,49673,226211,339945,14.3,2828,103413,130311,5.3,4.8,28.6
2001,Montana,1.4,19130,298356,14328,3281,11.9,1753,2963,10.8,1752,28989,48119,16.1,8125,29461,43789,14.7,4330,23852,27812,6.4,4.8,29.4
2001,Nebraska,-0.7,44434,749552,38589,4460,10,2408,4290,9.6,2408,59073,103507,13.8,13455,70091,108680,14.5,-5173,36406,44724,5.9,5.1,27.6
2001,Nevada,1.7,65893,907096,50433,6678,16.1,3584,5856,14.2,3582,92385,158278,17.4,25955,92296,142729,15.7,15549,33891,41920,7.3,5.6,31.4
2001,New Hampshire,2.4,29307,547963,26038,3499,10.5,2064,3389,10.2,2063,56046,85353,15.6,12603,46315,72353,13.2,13000,28145,33445,5.3,4.8,26.4
2001,New Jersey,2.4,240890,3563025,182706,23262,11.3,13347,21951,10.7,13346,369451,610341,17.1,85222,341171,523877,14.7,86464,175063,206569,6.8,5.1,29.4
2001,New Mexico,0.7,38876,546938,34788,4578,12.1,2497,4550,12,2497,57175,96051,17.6,14767,57683,92471,16.9,3580,30774,38131,7.1,6.4,33.8
2001,New York,0.5,400677,7342423,374608,48541,11.2,28461,45728,10.5,28441,678143,1078820,14.7,174109,671488,1046096,14.2,32724,368613,435878,5.5,5.1,28.4
2001,North Carolina,1.8,214223,3406151,182987,21575,11.8,11500,19914,10.9,11493,363258,577481,17,66882,333705,516692,15.2,60789,143568,183926,6.3,5.4,30.4
2001,North Dakota,0.4,13755,254796,10192,1588,8.8,1000,1639,9,1000,19278,33033,13,5891,22000,32192,12.6,841,15086,18151,5.4,4,25.2
2001,Ohio,-1.6,246386,4949147,230190,23095,9.4,13444,23364,9.5,13423,415749,662135,13.4,88090,512792,742982,15,-80847,187800,245998,5,4.7,26.8
2001,Oklahoma,0.2,74467,1201711,74238,8402,11,5099,8498,11.2,5097,118871,193338,16.1,29226,116649,190887,15.9,2451,61201,76322,6.2,6.2,31.8
2001,Oregon,0.2,80225,1341484,65910,10769,12.2,5993,10097,11.4,5981,130535,210760,15.7,30655,142392,208302,15.5,2458,73206,89075,6,4.9,31
2001,Pennsylvania,0.6,280974,5074989,236173,25913,9.7,14416,24685,9.2,14410,449700,730674,14.4,97846,466138,702311,13.8,28363,211582,269387,5.5,4.7,27.6
2001,Rhode Island,-0.2,19288,408389,15433,2523,10,1549,2461,9.7,1549,33763,53051,13,7742,38614,54047,13.2,-996,22226,25350,4.7,3.8,26
2001,South Carolina,-0.5,93277,1589658,82468,10050,11.5,6009,10038,11.5,6004,146529,239806,15.1,36357,165718,248186,15.6,-8380,68591,87289,5.9,5.2,30.2
2001,South Dakota,3.2,22592,307900,13000,2148,10.2,1252,2125,10.1,1251,27453,50045,16.3,6609,27480,40480,13.1,9565,17903,21198,7.3,4.2,26.2
2001,Tennessee,-0.9,131928,2370562,134588,12811,10.8,7905,13509,11.4,7899,226740,358668,15.1,58086,244153,378741,16,-20073,89932,118501,5.6,5.7,30.2
2001,Texas,1.8,603497,7990254,507173,53003,12.6,28682,48836,11.6,28655,861919,1465416,18.3,196233,807853,1315026,16.5,150390,322309,425543,7.6,6.3,33
2001,Utah,0.1,65353,909500,66401,7133,14.9,3528,6324,13.2,3523,100834,166187,18.3,27749,98802,165203,18.2,984,39288,48305,7.2,7.3,36.4
2001,Vermont,2.3,12198,256558,9532,1750,9.2,1084,1690,8.9,1084,22299,34497,13.4,5399,18864,28396,11.1,6101,16646,19155,4.8,3.7,22.2
2001,Virginia,1.6,189811,2885172,138425,17854,11.3,9112,16430,10.4,9107,291996,481807,16.7,54802,296857,435282,15.1,46525,123022,158779,6.6,4.8,30.2
2001,Washington,0.5,145408,2240956,126343,18076,12.6,10095,17248,12.1,10084,225852,371260,16.6,62798,234359,360702,16.1,10558,117733,143923,6.5,5.6,32.2
2001,West Virginia,-1,26161,552784,30460,3302,8.9,2340,4006,10.8,2339,49299,75460,13.7,11187,50911,81371,14.7,-5911,29540,36987,4.7,5.5,27.4
2001,Wisconsin,-0.7,112822,2390908,101143,11968,9.5,6976,11797,9.4,6965,187993,300815,12.6,42174,217228,318371,13.3,-17556,101603,126533,4.7,4.2,25.2
2001,Wyoming,1.6,11087,173823,9170,1860,11.7,1066,1824,11.5,1065,17918,29005,16.7,5007,17005,26175,15.1,2830,13730,15934,6.4,5.3,30.2
2002,Alabama,-2.1,105218,1588248,99095,10991,12.2,5792,10373,11.5,5783,150514,255732,16.1,34380,189444,288539,18.2,-32807,70077,90514,6.6,6.2,32.2
2002,Alaska,1.4,15967,212680,11891,2236,14.5,934,1924,12.5,932,24780,40747,19.2,4977,25861,37752,17.8,2995,12843,15592,7.5,5.6,35.6
2002,Arizona,-0.8,159839,1927572,137727,15428,15.1,7355,13663,13.3,7333,221623,381462,19.8,49935,259954,397681,20.6,-16219,80863,103369,8.3,7.1,39.6
2002,Arkansas,-1,67379,977695,62453,7343,13,3707,6439,11.4,3703,92462,159841,16.3,20029,106263,168716,17.3,-8875,45485,56845,6.9,6.4,32.6
2002,California,-2.1,1015751,12818076,950800,101565,14.3,51162,91260,12.8,51010,1359862,2375613,18.5,401927,1691914,2642714,20.6,-267101,576942,717239,7.9,7.4,37
2002,Colorado,-4.2,146320,1912195,160128,17767,14.7,8590,16288,13.5,8576,194408,340728,17.8,51313,260877,421005,22,-80277,99866,121531,7.7,8.4,35.6
2002,Connecticut,0.2,99528,1554153,79390,8852,10.7,4547,8968,10.9,4544,151322,250850,16.1,27319,166956,246346,15.9,4504,68260,82553,6.4,5.1,31.8
2002,Delaware,1.2,32164,383522,21594,2902,13.6,1240,2437,11.4,1234,37264,69428,18.1,6142,43173,64767,16.9,4661,17517,21580,8.4,5.6,33.8
2002,District of Columbia,-0.1,31071,427741,23079,2295,12.5,868,2025,11,865,40880,71951,16.8,7973,49156,72235,16.9,-284,15152,18529,7.3,5.4,33.6
2002,Florida,-1.1,507347,6304447,575265,58518,15.4,28494,51516,13.5,28433,718264,1225611,19.4,191699,714620,1289885,20.5,-64274,308428,383859,8,9.1,38.8
2002,Geogia,-1.7,267020,3393411,243870,25802,14.4,11977,23077,12.9,11952,326671,593691,17.5,90644,406349,650219,19.2,-56528,140616,180878,7.9,7.2,35
2002,Hawaii,-2.4,27456,445033,23247,3229,11.8,1515,2943,10.7,1511,39740,67196,15.1,8821,54631,77878,17.5,-10682,22048,27588,6.2,5.2,30.2
2002,Idaho,-2,37873,458027,32204,4788,14.6,2112,4088,12.5,2093,45457,83330,18.2,16533,60499,92703,20.2,-9373,27706,33112,8.3,7,36.4
2002,Illinois,-3.4,333176,5279031,340090,31177,11.4,15725,31806,11.6,15654,475042,808218,15.3,107232,647245,987335,18.7,-179117,219136,273122,6.3,6.4,30.6
2002,Indiana,-2.5,161667,2546235,142473,15292,11.5,7378,14632,11,7349,216840,378507,14.9,47962,299543,442016,17.4,-63509,102674,132863,6.3,5.6,29.8
2002,Iowa,-1.1,72984,1235896,61542,7519,10.4,3682,7357,10.1,3671,98181,171165,13.8,21751,122286,183828,14.9,-12663,57207,72588,5.9,5,27.6
2002,Kansas,-0.6,76975,1098925,62384,7952,11.9,4011,7672,11.5,4004,102517,179492,16.3,22995,123226,185610,16.9,-6118,53656,67138,7,5.7,32.6
2002,Kentucky,-1.6,91147,1480511,75575,9406,11.5,4821,8778,10.7,4805,132096,223243,15.1,28352,171810,247385,16.7,-24142,64117,82105,6.2,5.1,30.2
2002,Louisiana,-0.7,107376,1568055,95474,10721,11.7,5333,9831,10.7,5323,156462,263838,16.8,39257,178365,273839,17.5,-10001,72883,92272,6.8,6.1,33.6
2002,Maine,-2.3,30160,485972,28769,4072,11.8,2050,3934,11.4,2049,40853,71013,14.6,12442,53199,81968,16.9,-10955,28897,34629,6.2,5.9,29.2
2002,Maryland,-0.4,145830,2057930,127418,14648,12.7,6456,12973,11.3,6443,199020,344850,16.8,48761,227478,354896,17.2,-10046,93310,115980,7.1,6.2,33.6
2002,Massachusetts,-2.8,193803,3034533,190309,17807,11.5,8501,16443,10.6,8493,283831,477634,15.7,64209,370996,561305,18.5,-83671,126934,155655,6.4,6.3,31.4
2002,Michigan,-2.4,270925,3916952,258412,24375,11.7,12353,25407,12.2,12314,357784,628709,16.1,86366,467709,726121,18.5,-97412,165183,208342,6.9,6.6,32.2
2002,Minnesota,-1.4,143375,2376190,134671,14588,11.8,6841,14002,11.3,6829,222971,366346,15.4,45248,263594,398265,16.8,-31919,99908,124221,6,5.7,30.8
2002,Mississippi,-1.6,61746,906736,56410,6656,12.4,3478,6165,11.5,3472,79997,141743,15.6,20344,99924,156334,17.2,-14591,42445,53952,6.8,6.2,31.2
2002,Missouri,-1.4,156986,2361022,138992,16576,12.7,8183,15145,11.6,8174,219855,376841,16,53275,272489,411481,17.4,-34640,104206,131575,6.6,5.9,32
2002,Montana,0.3,20529,299093,16357,3588,12.8,1756,3268,11.7,1755,30704,51233,17.1,7788,33915,50272,16.8,961,24027,28084,6.9,5.5,33.6
2002,Nebraska,0.4,41540,745089,34362,4951,11,2376,4559,10.2,2372,69820,111360,14.9,12600,73680,108042,14.5,3318,36585,45065,5.6,4.6,29
2002,Nevada,0.8,79909,927089,54283,7492,17.6,3425,6002,14.1,3423,97717,177626,19.2,24374,115920,170203,18.4,7423,34901,43335,8.6,5.9,36.8
2002,New Hampshire,-2.6,30642,544591,32762,3790,11.3,2047,3717,11.1,2046,48111,78753,14.5,11745,60112,92874,17.1,-14121,28009,33463,5.6,6,29
2002,New Jersey,-0.3,233694,3579695,215036,25434,12.3,13414,24119,11.7,13393,380141,613835,17.1,81982,407585,622621,17.4,-8786,175184,207594,6.5,6,34.2
2002,New Mexico,1.1,44765,547163,35348,5033,13.2,2440,4763,12.5,2439,58435,103200,18.9,14833,61844,97192,17.8,6008,31067,38353,8.2,6.5,35.6
2002,New York,-1.1,509627,7307112,495949,53883,12.4,29059,51539,11.8,29028,726960,1236587,16.9,183648,816115,1312064,18,-75477,369756,437453,7,6.8,33.8
2002,North Carolina,-2.6,223471,3379608,201709,22739,12.3,11477,21563,11.7,11442,293544,517015,15.3,67807,404480,606189,17.9,-89174,143912,184890,6.6,6,30.6
2002,North Dakota,-0.9,17757,253617,13636,1795,9.9,925,1746,9.6,925,19921,37678,14.9,5854,26389,40025,15.8,-2347,14977,18155,7,5.4,29.8
2002,Ohio,-2.8,289367,4821129,271503,25753,10.5,13096,26668,10.9,13067,438515,727882,15.1,93834,590475,861978,17.9,-134096,186689,244789,6,5.6,30.2
2002,Oklahoma,-0.5,86079,1192062,79837,9589,12.5,4765,8780,11.5,4748,123273,209352,17.6,32902,135436,215273,18.1,-5921,62013,77044,7.2,6.7,35.2
2002,Oregon,-1.5,95654,1329790,81174,11457,12.8,5811,10834,12.2,5796,125498,221152,16.6,32834,159713,240887,18.1,-19735,73305,89479,7.2,6.1,33.2
2002,Pennsylvania,-0.2,336093,5067158,319300,28418,10.6,13966,28005,10.4,13921,484156,820249,16.2,99813,514103,833403,16.4,-13154,211471,269383,6.6,6.3,32.4
2002,Rhode Island,1.1,26949,411589,19180,2820,11.1,1465,2762,10.9,1465,37700,64649,15.7,7185,40741,59921,14.6,4728,22155,25365,6.5,4.7,29.2
2002,South Carolina,-2.8,101660,1553749,90436,11069,12.6,5684,10240,11.7,5673,140654,242314,15.6,35152,195358,285794,18.4,-43480,69041,88108,6.5,5.8,31.2
2002,South Dakota,-3.4,18589,307387,23317,2647,12.4,1223,2180,10.2,1223,30728,49317,16,7221,36328,59645,19.4,-10328,18176,21627,6,7.6,32
2002,Tennessee,-2.9,147901,2317203,151102,14063,11.9,7698,14299,12.1,7673,215729,363630,15.7,50428,279093,430195,18.6,-66565,89467,118103,6.4,6.5,31.4
2002,Texas,-0.9,670544,7985108,567821,58380,13.6,28305,52959,12.4,28205,824712,1495256,18.7,194401,996179,1564000,19.6,-68744,326189,430507,8.4,7.1,37.4
2002,Utah,-0.5,73245,908421,60762,8077,16.5,3418,6580,13.4,3412,94198,167443,18.4,26180,110734,171496,18.9,-4053,40563,49692,8.1,6.7,36.8
2002,Vermont,-0.2,16039,259289,14651,1962,10.3,1053,2077,10.9,1052,23799,39838,15.4,5950,25797,40448,15.6,-610,16540,19030,6.2,5.7,30.8
2002,Virginia,-0.6,206894,2901575,185609,20335,12.7,9032,17816,11.1,9013,285996,492890,17,60569,324099,509708,17.6,-16818,124823,161150,7.1,6.4,34
2002,Washington,-2.6,181095,2208713,139819,19689,13.7,10267,18940,13.2,10245,199353,380448,17.2,61774,297215,437034,19.8,-56586,117722,144263,8.2,6.3,34.4
2002,West Virginia,1.1,31672,552933,30836,3971,10.8,2196,4058,11,2191,60368,92040,16.6,11746,54764,85600,15.5,6440,29297,36872,5.7,5.6,31
2002,Wisconsin,-1.1,131810,2368803,114042,13623,10.8,6821,13193,10.4,6802,203677,335487,14.2,44492,249088,363130,15.3,-27643,101507,126757,5.6,4.8,28.4
2002,Wyoming,0.6,13691,175727,13177,2247,13.9,1015,1843,11.4,1014,19817,33508,19.1,5185,19350,32527,18.5,981,14094,16311,7.8,7.5,37
2003,Alabama,2.5,90416,1568996,62743,10017,11.1,5760,7888,8.7,5758,159918,250334,16,34078,149362,212105,13.5,38229,70389,91024,5.8,4,27
2003,Alaska,3.9,15157,215035,9520,2090,13.4,893,1509,9.7,893,25853,41010,19.1,4825,23074,32594,15.2,8416,13024,15833,7,4.4,30.4
2003,Arizona,3.9,147241,1925357,102398,14952,14.4,7326,10806,10.4,7307,236869,384110,20,56271,208342,310740,16.1,73370,82422,105379,7.6,5.3,32.2
2003,Arkansas,2.3,47854,970507,34011,6808,11.9,3680,4963,8.7,3674,92802,140656,14.5,19933,84727,118738,12.2,21918,46058,57745,4.9,3.5,24.4
2003,California,2.6,868476,12663136,642430,97057,13.5,52205,74727,10.4,51510,1438191,2306667,18.2,375679,1337832,1980262,15.6,326405,584851,726275,6.9,5.1,31.2
2003,Colorado,0.3,132282,1849474,109388,17237,14.2,8642,13279,10.9,8630,185441,317723,17.2,57235,203110,312498,16.9,5225,101302,123153,7.2,5.9,33.8
2003,Connecticut,0.7,61698,1540149,65692,7787,9.5,4617,7201,8.8,4611,150777,212475,13.8,27701,135359,201051,13.1,11424,67782,82021,4,4.3,26.2
2003,Delaware,-0.7,19469,381541,17962,2620,12.1,1292,1963,9.1,1290,32226,51695,13.5,7643,36243,54205,14.2,-2510,17769,21872,5.1,4.7,27
2003,District of Columbia,1.7,19317,423505,13227,1733,9.4,893,1493,8.1,893,40067,59384,14,6472,38691,51918,12.3,7466,15058,18440,4.6,3.1,24.6
2003,Florida,3.7,525256,6279440,401009,60406,15.6,29664,42614,11,29592,761923,1287179,20.5,219878,655961,1056970,16.8,230209,318351,394031,8.4,6.4,33.6
2003,Geogia,1.3,215831,3328426,153700,24713,13.6,12122,18127,10,12107,330007,545838,16.4,78635,347402,501102,15.1,44736,143256,183617,6.5,4.6,30.2
2003,Hawaii,5,23990,447271,18088,3056,11,1470,2147,7.8,1470,47401,71391,16,10795,31097,49185,11,22206,22481,28057,5.4,4,22
2003,Idaho,3.6,28691,456694,19630,4805,14.4,2209,3273,9.8,2198,50477,79168,17.3,11615,42847,62477,13.7,16691,28547,34059,6.3,4.3,27.4
2003,Illinois,1.2,261102,5159626,217835,29869,11,15604,24031,8.8,15508,503801,764903,14.8,110540,481367,699202,13.6,65701,220163,274745,5.1,4.2,27.2
2003,Indiana,2.3,126939,2507247,100396,13499,10.2,7443,10945,8.3,7372,252379,379318,15.1,51394,219416,319812,12.8,59506,102801,133203,5.1,4,25.6
2003,Iowa,1,57208,1220835,41229,7085,9.8,3753,5830,8.1,3751,101590,158798,13,24463,104906,146135,12,12663,57316,72666,4.7,3.4,24
2003,Kansas,2.3,68117,1091202,45037,7241,10.8,4026,5852,8.7,4015,97430,165547,15.2,23483,95759,140796,12.9,24751,53796,67382,6.2,4.1,25.8
2003,Kentucky,1.6,74923,1464469,56828,8384,10.2,4858,6883,8.4,4820,136969,211892,14.5,31592,132495,189323,12.9,22569,64051,82328,5.1,3.9,25.8
2003,Louisiana,3,85311,1564329,62419,9843,10.7,5406,7552,8.2,5399,169899,255210,16.3,37997,145551,207970,13.3,47240,73479,92862,5.5,4,26.6
2003,Maine,1.2,25387,478773,20308,3840,11.1,1930,2968,8.6,1927,42710,68097,14.2,10872,41815,62123,13,5974,29212,35019,5.3,4.2,26
2003,Maryland,2.7,117415,2050427,79347,13577,11.7,6500,9990,8.6,6499,210091,327506,16,41351,194067,273414,13.3,54092,94754,117670,5.7,3.9,26.6
2003,Massachusetts,0.3,143060,2959415,135946,17776,11.4,8836,13751,8.8,8819,280409,423469,14.3,60245,278595,414541,14,8928,128664,157413,4.8,4.6,28
2003,Michigan,0.7,220160,3831397,168444,22109,10.7,12430,19051,9.2,12311,375393,595553,15.5,99286,399601,568045,14.8,27508,164940,208078,5.7,4.4,29.6
2003,Minnesota,1.7,137249,2355742,96595,14378,11.5,6659,10695,8.6,6656,223330,360579,15.3,47174,224044,320639,13.6,39940,101285,125911,5.8,4.1,27.2
2003,Mississippi,2,51295,895194,36020,6213,11.5,3533,4795,8.9,3530,88552,139847,15.6,23720,86024,122044,13.6,17803,42757,54397,5.7,4,27.2
2003,Missouri,2.6,115837,2346532,90699,15854,12,8394,12082,9.2,8386,238523,354360,15.1,49876,202493,293192,12.5,61168,105596,133144,4.9,3.9,25
2003,Montana,2.6,19833,301191,12935,3559,12.6,1661,2558,9,1660,29689,49522,16.4,7754,28507,41442,13.8,8080,24613,28690,6.6,4.3,27.6
2003,Nebraska,3.3,38431,746681,25809,4581,10.2,2352,3538,7.9,2351,78676,117107,15.7,12748,66901,92710,12.4,24397,36878,45452,5.1,3.5,24.8
2003,Nevada,4.3,70464,943439,41795,7627,17.4,3485,4950,11.3,3478,103129,173593,18.4,23116,91313,133108,14.1,40485,36379,45098,7.5,4.4,28.2
2003,New Hampshire,0.6,29234,529778,22853,3682,11,2080,3082,9.2,2079,46697,75931,14.3,11890,49904,72757,13.7,3174,28078,33604,5.5,4.3,27.4
2003,New Jersey,0.9,208681,3541138,176634,24638,11.9,13901,21006,10.1,13887,369358,578039,16.3,91754,369407,546041,15.4,31998,175699,208335,5.9,5,30.8
2003,New Mexico,4.4,38774,557231,26964,4662,12.2,2355,3578,9.3,2349,60772,99546,17.9,13916,48424,75388,13.5,24158,31396,38724,7,4.8,27
2003,New York,2.1,393085,7280882,314016,52871,12.1,29582,42837,9.8,29545,758952,1152037,15.8,180548,685242,999258,13.7,152779,374131,442102,5.4,4.3,27.4
2003,North Carolina,1.4,211300,3312400,151840,21998,11.9,11407,16816,9.1,11385,320724,532024,16.1,71088,335721,487561,14.7,44463,145137,186530,6.4,4.6,29.4
2003,North Dakota,3.1,11199,254197,8546,1606,8.9,843,1311,7.2,843,24233,35432,13.9,4879,18796,27342,10.8,8090,15017,18201,4.4,3.4,21.6
2003,Ohio,1.2,232696,4723630,178901,23741,9.8,13178,20094,8.3,13109,453927,686623,14.5,93232,449362,628263,13.3,58360,186122,244400,4.9,3.8,26.6
2003,Oklahoma,0,61419,1172193,52769,8663,11.3,5039,6868,8.9,5035,117846,179265,15.3,30479,126294,179063,15.3,202,62290,77491,5.2,4.5,30.6
2003,Oregon,2.1,67079,1318704,61645,11231,12.5,5660,8382,9.3,5655,144803,211882,16.1,32614,123592,185237,14,26645,74412,90720,5.1,4.7,28
2003,Pennsylvania,1.1,254344,5026353,189728,26358,9.8,14308,21653,8.1,14244,486959,741303,14.7,95614,491347,681075,13.6,60228,211726,270120,5.1,3.8,27.2
2003,Rhode Island,2.3,21020,415644,15318,2840,11.2,1420,2240,8.8,1412,41247,62267,15,8217,37657,52975,12.7,9292,22410,25649,5.1,3.7,25.4
2003,South Carolina,1.6,100371,1523515,68511,10565,12,5624,7889,8.9,5619,144715,245086,16.1,36313,152642,221153,14.5,23933,69949,89195,6.6,4.5,29
2003,South Dakota,-0.7,14408,295917,18019,2255,10.5,1204,1900,8.8,1204,26632,41040,13.9,6292,25090,43109,14.6,-2069,18242,21602,4.9,6.1,27.8
2003,Tennessee,1.9,137790,2270881,93757,13491,11.5,7478,10789,9.2,7466,225768,363558,16,49607,227026,320783,14.1,42775,89753,118634,6.1,4.1,28.2
2003,Texas,1.5,559664,7883519,448254,55434,12.9,29446,42723,9.9,29295,845745,1405409,17.8,223940,834220,1282474,16.3,122935,329597,434347,7.1,5.7,32.6
2003,Utah,1.2,70890,899056,52601,8091,16.1,3814,5868,11.7,3807,90285,161175,17.9,31165,97444,150045,16.7,11130,41930,51004,7.9,5.9,33.4
2003,Vermont,0.2,12673,256541,11740,2003,10.5,1034,1578,8.3,1033,23435,36108,14.1,6301,23975,35715,13.9,393,16607,19194,4.9,4.6,27.8
2003,Virginia,1.5,163043,2879374,124259,19359,12,9206,14040,8.7,9154,281813,444856,15.4,62298,275201,399460,13.9,45396,126692,163596,5.7,4.3,27.8
2003,Washington,2.1,131187,2176370,105550,19070,13.2,9801,14668,10.2,9784,227767,358954,16.5,52630,207971,313521,14.4,45433,119368,145955,6,4.8,28.8
2003,West Virginia,0.9,31680,552460,19512,3580,9.8,2092,3054,8.3,2087,46913,78593,14.2,11823,53725,73237,13.3,5356,29068,36719,5.7,3.5,26.6
2003,Wisconsin,1.9,113807,2353500,80976,12450,9.9,6949,10518,8.3,6924,214446,328253,13.9,44342,201244,282220,12,46033,101373,126867,4.8,3.4,24
2003,Wyoming,2.1,10152,175244,8418,2006,12.3,1068,1588,9.7,1063,19201,29353,16.7,5063,17137,25555,14.6,3798,14253,16463,5.8,4.8,29.2
2004,Alabama,2.4,84394,1593465,74582,9704,10.7,5556,8192,9,5541,168772,253166,15.9,35392,140599,215181,13.5,37985,71030,91635,5.3,4.7,27
2004,Alaska,3,10959,219737,10056,2043,12.9,965,1602,10.1,965,24833,35792,16.3,5012,19098,29154,13.3,6638,13232,16068,5,4.6,26.6
2004,Arizona,3.5,131641,1977291,104476,14825,13.9,7142,10886,10.2,7127,233678,365319,18.5,56581,192558,297034,15,68285,84566,107925,6.7,5.3,30
2004,Arkansas,2.3,45658,981830,37396,6384,11,3738,5260,9.1,3732,95949,141607,14.4,20883,81248,118644,12.1,22963,46617,58378,4.7,3.8,24.2
2004,California,2.4,832114,12857225,692822,92650,12.7,52330,77649,10.7,52216,1409387,2241501,17.4,382609,1235775,1928597,15,312904,590973,732203,6.5,5.4,30
2004,Colorado,2.4,132009,1859698,94918,16774,13.5,8587,13420,10.8,8565,186340,318349,17.1,50440,178802,273720,14.7,44629,103024,125166,7.1,5.1,29.4
2004,Connecticut,-0.8,63325,1528447,74204,8149,9.9,4381,6792,8.3,4370,128158,191483,12.5,36689,129606,203810,13.3,-12327,68204,82674,4.1,4.9,25
2004,Delaware,1.5,20542,383101,17891,2678,12.1,1258,1985,9,1251,35677,56219,14.7,6988,32488,50379,13.2,5840,18122,22370,5.4,4.7,26.4
2004,District of Columbia,2.9,17627,431361,13441,1398,7.7,906,1550,8.5,901,41130,58757,13.6,6219,32615,46056,10.7,12701,14643,18110,4.1,3.1,21.4
2004,Florida,2.1,471338,6415540,486440,66023,16.4,30753,44930,11.2,30541,783094,1254432,19.6,206345,633262,1119702,17.5,134730,334147,410603,7.3,7.6,35
2004,Geogia,3.3,210294,3367663,161569,24233,13.1,11960,18134,9.8,11921,371584,581878,17.3,78683,311350,472919,14,108959,146935,187539,6.2,4.8,28
2004,Hawaii,3.3,22358,464422,16405,3007,10.6,1509,2266,8,1509,43806,66164,14.2,9510,34414,50819,10.9,15345,22874,28569,4.8,3.5,21.8
2004,Idaho,5.4,40933,473118,21571,4774,13.8,2144,3374,9.8,2136,46540,87473,18.5,10303,40527,62098,13.1,25375,29555,35133,8.7,4.6,26.2
2004,Illinois,1.2,244223,5181021,215137,29344,10.7,15419,24749,9,15326,505596,749819,14.5,106565,472816,687953,13.3,61866,222385,276780,4.7,4.2,26.6
2004,Indiana,2.2,119741,2548059,98076,13434,10.1,7311,10980,8.2,7304,240665,360406,14.1,49983,205458,303534,11.9,56872,103599,134402,4.7,3.8,23.8
2004,Iowa,1.3,49847,1226941,46945,6696,9.2,3785,5895,8.1,3776,109018,158865,12.9,20449,95278,142223,11.6,16642,57614,72962,4.1,3.8,23.2
2004,Kansas,0.4,55228,1102299,45888,6977,10.3,3818,5827,8.6,3816,93919,149147,13.5,23437,98268,144156,13.1,4991,54318,67890,5,4.2,26.2
2004,Kentucky,2.4,77019,1469536,61654,8383,10.2,4716,7014,8.5,4710,139611,216630,14.7,32086,119672,181326,12.3,35304,64571,82909,5.2,4.2,24.6
2004,Louisiana,1.4,75305,1590616,71414,9440,10.1,5330,7831,8.4,5313,167019,242324,15.2,38543,147702,219116,13.8,23208,74281,93648,4.7,4.5,27.6
2004,Maine,1.5,20003,482117,18881,3759,10.7,2039,3083,8.8,2024,41473,61476,12.8,10874,35555,54436,11.3,7040,29527,35386,4.1,3.9,22.6
2004,Maryland,3.2,114267,2098798,92193,13569,11.5,6587,10333,8.7,6570,220015,334282,15.9,47411,173718,265911,12.7,68371,96808,119855,5.4,4.4,25.4
2004,Massachusetts,0.6,137182,2957921,118890,15915,10.2,11469,16230,10.4,11444,256564,393746,13.3,56978,255707,374597,12.7,19149,127072,155806,4.6,4,25.4
2004,Michigan,0.8,205579,3829976,176339,21276,10.3,12098,19453,9.4,12029,354027,559606,14.6,88558,351697,528036,13.8,31570,165233,207693,5.4,4.6,27.6
2004,Minnesota,0.7,107975,2371469,103988,14153,11.2,6723,10985,8.7,6708,211748,319723,13.5,48008,199233,303221,12.8,16502,102969,127848,4.6,4.4,25.6
2004,Mississippi,2.5,52764,910625,40481,5819,10.7,3396,4873,8.9,3385,86205,138969,15.3,19426,75997,116478,12.8,22491,43115,54880,5.8,4.4,25.6
2004,Missouri,1.6,125140,2375540,109517,16213,12.1,8644,12649,9.4,8641,225599,350739,14.8,53336,204975,314492,13.2,36247,107735,135422,5.3,4.6,26.4
2004,Montana,3.4,16973,307386,15246,3783,13,1723,2739,9.4,1722,31964,48937,15.9,8221,23111,38357,12.5,10580,25346,29441,5.5,5,25
2004,Nebraska,2.3,34275,762719,23282,4373,9.6,2413,3692,8.1,2392,63374,97649,12.8,12664,56781,80063,10.5,17586,37146,45736,4.5,3.1,21
2004,Nevada,6,70770,985030,49128,7754,16.9,3617,5290,11.5,3598,119549,190319,19.3,26286,81434,130562,13.3,59757,38027,46978,7.2,5,26.6
2004,New Hampshire,1.7,22461,533310,20818,3776,11.2,2020,2972,8.8,2003,46123,68584,12.9,12458,38760,59578,11.2,9006,28530,34129,4.2,3.9,22.4
2004,New Jersey,2,182957,3550917,167233,24187,11.6,13816,21544,10.3,13785,381929,564886,15.9,83009,325559,492792,13.9,72094,177637,209227,5.2,4.7,27.8
2004,New Mexico,2.3,33148,569294,29103,4497,11.6,2352,3600,9.3,2352,59851,92999,16.3,14107,50412,79515,14,13484,31864,39221,5.8,5.1,28
2004,New York,1.1,369065,7350398,324709,53167,12,30374,45249,10.2,30312,720941,1090006,14.8,181217,680135,1004844,13.7,85162,378394,446777,5,4.4,27.4
2004,North Carolina,1.2,169950,3319460,148505,21541,11.5,11119,16770,8.9,11079,328773,498723,15,73032,307938,456443,13.8,42280,147765,189305,5.1,4.5,27.6
2004,North Dakota,2.1,10083,259181,11350,1662,9.1,872,1315,7.2,872,22842,32925,12.7,4867,16115,27465,10.6,5460,15238,18416,3.9,4.4,21.2
2004,Ohio,0.5,211660,4726164,200996,23242,9.5,13057,20294,8.3,13006,416374,628034,13.3,104142,402363,603359,12.8,24675,186189,244899,4.5,4.3,25.6
2004,Oklahoma,1.8,65494,1171524,50084,8482,10.9,4792,6922,8.9,4758,117130,182624,15.6,27692,111800,161884,13.8,20740,62993,78328,5.6,4.3,27.6
2004,Oregon,1.7,72832,1334221,65742,11116,12.2,5798,8759,9.6,5788,124804,197636,14.8,31602,109003,174745,13.1,22891,75631,92243,5.5,4.9,26.2
2004,Pennsylvania,1.1,227768,5054253,233421,26065,9.6,14056,21872,8.1,14038,472237,700005,13.8,115152,408198,641619,12.7,58386,213608,272071,4.5,4.6,25.4
2004,Rhode Island,3.5,19763,425119,15516,2960,11.4,1451,2141,8.3,1450,42161,61924,14.6,8989,31779,47295,11.1,14629,22957,26308,4.6,3.6,22.2
2004,South Carolina,1.1,85524,1530224,69967,10368,11.6,5483,8021,8.9,5482,143166,228690,14.9,35909,141542,211509,13.8,17181,71160,90634,5.6,4.6,27.6
2004,South Dakota,3.2,14061,297732,13026,2284,10.5,1212,1810,8.3,1212,30456,44517,15,6461,22196,35222,11.8,9295,18550,21933,4.7,4.4,23.6
2004,Tennessee,2.6,124063,2303377,99313,13153,11.1,7085,10513,8.8,7068,228556,352619,15.3,49787,192553,291866,12.7,60753,90970,120055,5.4,4.3,25.4
2004,Texas,1.9,552369,7951949,431467,53806,12.4,29559,43807,10.1,29471,825600,1377969,17.3,215391,790251,1221718,15.4,156251,333499,439327,6.9,5.4,30.8
2004,Utah,5.4,64177,917082,44311,7976,15.4,3662,5685,11,3661,111530,175707,19.2,23687,82616,126927,13.8,48780,43504,52689,7,4.8,27.6
2004,Vermont,-0.2,10113,254759,8621,1910,9.9,989,1526,7.9,989,18371,28484,11.2,5101,20408,29029,11.4,-545,16846,19428,4,3.4,22.4
2004,Virginia,4.5,169287,2946653,114356,19757,12,8925,13858,8.4,8906,323055,492342,16.7,59257,246180,360536,12.2,131806,130500,167869,5.7,3.9,24.4
2004,Washington,3.1,130621,2220614,92476,18789,12.8,9707,14670,10,9700,227229,357850,16.1,52073,197312,289788,13,68062,121553,148614,5.9,4.2,26
2004,West Virginia,1.9,23635,555586,19465,3608,9.8,2076,3007,8.2,2058,51465,75100,13.5,11217,45129,64594,11.6,10506,29277,36990,4.3,3.5,23.2
2004,Wisconsin,2.7,112091,2394019,84529,12238,9.6,6505,9919,7.8,6469,216039,328130,13.7,42359,178059,262588,11,65542,102322,128176,4.7,3.5,22
2004,Wyoming,4.6,10355,180378,7568,1974,11.9,998,1549,9.3,998,20290,30645,17,4429,14817,22385,12.4,8260,14522,16761,5.7,4.2,24.8
2005,Alabama,3.4,94471,1631579,64618,10115,11,5598,7823,8.5,5581,179105,273576,16.8,37789,153218,217836,13.4,55740,71912,93111,5.8,4,26.8
2005,Alaska,3.2,11233,226102,7284,1989,12.3,954,1489,9.2,954,24897,36130,16,4564,21549,28833,12.8,7297,13471,16436,5,3.2,25.6
2005,Arizona,6.7,174605,2069130,96580,16546,15,7207,10455,9.5,7203,248386,422991,20.4,54239,186645,283225,13.7,139766,88023,112792,8.4,4.7,27.4
2005,Arkansas,2.3,52579,1001337,37751,6640,11.3,3915,5192,8.8,3909,89725,142304,14.2,24263,81857,119608,11.9,22696,47064,59357,5.3,3.8,23.8
2005,California,1.9,854824,13052191,637404,101138,13.7,52838,74499,10.1,52690,1325584,2180408,16.7,386688,1293096,1930500,14.8,249908,605273,751942,6.5,4.9,29.6
2005,Colorado,2.5,131535,1892777,99581,18113,14.3,8721,13156,10.4,8689,186287,317822,16.8,60685,170501,270082,14.3,47740,105962,128910,6.9,5.3,28.6
2005,Connecticut,0.4,95135,1518199,75888,8673,10.5,4584,7104,8.6,4581,117591,212726,14,35113,129830,205718,13.6,7008,68836,83631,6.3,5,27.2
2005,Delaware,1,20713,387117,21993,2507,11.2,1280,2172,9.7,1277,35682,56395,14.6,9911,30540,52533,13.6,3862,18337,22486,5.4,5.7,27.2
2005,District of Columbia,2.2,22051,440088,12366,2420,13.1,771,1399,7.6,765,36639,58690,13.3,4963,36534,48900,11.1,9790,15363,18966,5,2.8,22.2
2005,Florida,4.2,564985,6580273,389267,69028,16.4,31606,45090,10.7,31495,743600,1308585,19.9,245309,646405,1035672,15.7,272913,350111,430317,8.6,5.9,31.4
2005,Geogia,2.2,222054,3431017,163235,25803,13.6,12459,18319,9.6,12446,340137,562191,16.4,94906,323285,486520,14.2,75671,151220,193210,6.5,4.8,28.4
2005,Hawaii,3.7,29524,479279,18263,3022,10.5,1513,2163,7.5,1488,44105,73629,15.4,11864,37899,56162,11.7,17467,23342,29218,6.2,3.8,23.4
2005,Idaho,5.9,40162,498015,25513,5447,15.1,2213,3256,9,2211,54557,94719,19,13245,39899,65412,13.1,29307,31202,37008,8.1,5.1,26.2
2005,Illinois,0.8,281928,5206469,216830,31443,11.3,15939,24906,9,15895,456901,738829,14.2,119666,481578,698408,13.4,40421,225231,280786,5.4,4.2,26.8
2005,Indiana,1.6,136039,2581586,95130,13520,10,7731,11318,8.4,7695,219611,355650,13.8,58069,220257,315387,12.2,40263,104070,135432,5.3,3.7,24.4
2005,Iowa,2,51552,1240617,38837,6891,9.4,3915,5678,7.8,3895,103500,155052,12.5,23536,91893,130730,10.5,24322,58095,73657,4.2,3.1,21
2005,Kansas,1.4,59516,1107069,49074,7110,10.4,3961,5647,8.3,3950,97300,156816,14.2,22931,92328,141402,12.8,15414,54925,68722,5.4,4.4,25.6
2005,Kentucky,1.8,76880,1494006,54583,8675,10.4,4997,6993,8.4,4976,142360,219240,14.7,34179,137815,192398,12.9,26842,65155,83888,5.1,3.7,25.8
2005,Louisiana,0.5,87349,1591094,81703,9481,10.1,5682,7988,8.5,5661,159704,247053,15.5,46805,156404,238107,15,8946,74343,94119,5.5,5.1,30
2005,Maine,1.5,23141,487321,16363,3942,11.1,2030,3049,8.6,2028,40390,63531,13,10046,39678,56041,11.5,7490,30029,36035,4.7,3.4,23
2005,Maryland,1.3,116536,2136365,92183,14356,11.9,6912,10671,8.8,6888,194948,311484,14.6,47335,192921,285104,13.3,26380,98925,122494,5.5,4.3,26.6
2005,Massachusetts,1.3,142639,2965989,114721,16184,10.4,10016,14538,9.3,9994,247867,390506,13.2,59204,238312,353033,11.9,37473,126867,156237,4.8,3.9,23.8
2005,Michigan,-2,203619,3783823,163445,21973,10.6,12501,19009,9.1,12432,305641,509260,13.5,98464,424349,587794,15.5,-78534,166027,208880,5.4,4.3,27
2005,Minnesota,2.6,129092,2396825,85388,14093,11,7015,10955,8.5,7009,212554,341646,14.3,46889,195775,281163,11.7,60483,104632,129977,5.4,3.6,23.4
2005,Mississippi,0.8,50186,917686,38416,5953,10.8,3581,4977,9.1,3568,80654,130840,14.3,24395,85780,124196,13.5,6644,43151,55247,5.5,4.2,27
2005,Missouri,1,134550,2392461,95285,16834,12.3,9077,12655,9.3,9065,197453,332003,13.9,62935,214453,309738,12.9,22265,109890,138449,5.6,4,25.8
2005,Montana,3.2,19764,316337,11580,3842,12.9,1823,2657,8.9,1817,29063,48827,15.4,7710,27066,38646,12.2,10181,26175,30376,6.2,3.7,24.4
2005,Nebraska,0.7,35439,769377,25254,4504,9.8,2448,3551,7.7,2438,71068,106507,13.8,15097,75379,100633,13.1,5874,37553,46300,4.6,3.3,26.2
2005,Nevada,6.3,81571,1042919,61929,8322,17.3,3867,5386,11.2,3865,126776,208347,20,35349,80913,142842,13.7,65505,39944,49397,7.8,5.9,27.4
2005,New Hampshire,2.5,30351,541897,20028,3939,11.5,2141,3045,8.9,2140,43504,73855,13.6,13077,40341,60369,11.1,13486,28956,34769,5.6,3.7,22.2
2005,New Jersey,-0.1,197025,3553499,181626,25604,12.2,14368,21021,10,14356,318293,515318,14.5,95454,336463,518089,14.6,-2771,180091,212238,5.5,5.1,29
2005,New Mexico,3,35146,581465,24115,4672,11.8,2406,3492,8.8,2396,63700,98846,17,15245,57121,81236,14,17610,32438,40056,6,4.1,28
2005,New York,0.7,422126,7375824,340100,53326,11.9,30992,45516,10.1,30952,640336,1062462,14.4,197576,667872,1007972,13.7,54490,384163,451631,5.7,4.6,27.4
2005,North Carolina,2.5,211759,3359538,135521,23281,12.2,11645,16842,8.8,11606,322407,534166,15.9,77305,315876,451397,13.4,82769,151442,193993,6.3,4,26.8
2005,North Dakota,3.2,13826,265229,10192,1820,9.8,913,1393,7.5,913,23255,37081,14,4456,18561,28753,10.8,8328,15462,18736,5.2,3.8,21.6
2005,Ohio,0.8,248028,4726960,193220,23518,9.6,13490,20405,8.3,13457,417561,665589,14.1,108152,436430,629650,13.3,35939,186389,246001,5.2,4.1,26.6
2005,Oklahoma,2.3,74331,1192297,57444,9062,11.5,5017,6982,8.9,5008,112360,186691,15.7,35698,102484,159928,13.4,26763,63843,79697,6.2,4.8,26.8
2005,Oregon,4.8,89629,1369622,56929,12411,13.3,5753,8535,9.1,5748,135178,224807,16.4,34001,102324,159253,11.6,65554,78290,95360,6.5,4.2,23.2
2005,Pennsylvania,0.3,260419,5062801,215377,27814,10.2,14917,22469,8.2,14870,411628,672047,13.3,110175,440489,655866,13,16181,215632,275372,5.1,4.3,26
2005,Rhode Island,1.5,21819,433121,14857,2917,11,1624,2399,9.1,1624,33871,55690,12.9,9942,34526,49383,11.4,6307,23166,26675,5,3.4,22.8
2005,South Carolina,2.8,94590,1551434,57262,11257,12.3,5723,7976,8.7,5710,146500,241090,15.5,35455,139172,196434,12.7,44656,72961,93164,6.1,3.7,25.4
2005,South Dakota,2.4,13486,304208,10468,2371,10.7,1217,1802,8.2,1217,28321,41807,13.7,5730,23766,34234,11.3,7573,18890,22338,4.4,3.4,22.6
2005,Tennessee,2,126515,2341395,93180,13659,11.3,7520,10705,8.9,7507,228413,354928,15.2,53794,215704,308884,13.2,46044,92051,121869,5.4,4,26.4
2005,Texas,2.9,582885,8097394,393096,56076,12.7,29652,42154,9.5,29533,824097,1406982,17.4,239955,777661,1170757,14.5,236225,339128,448680,7.2,4.9,29
2005,Utah,4,67925,954056,49560,8635,16.1,3783,5716,10.6,3773,111997,179922,18.9,28465,92638,142198,14.9,37724,45597,55091,7.1,5.2,29.8
2005,Vermont,2.7,11602,256746,9684,1923,9.9,1096,1617,8.3,1093,23933,35535,13.8,6060,18911,28595,11.1,6940,16982,19618,4.5,3.8,22.2
2005,Virginia,1.8,176325,3018187,112578,20636,12.2,9719,14589,8.6,9668,281677,458002,15.2,57677,291588,404166,13.4,53836,134080,172304,5.8,3.7,26.8
2005,Washington,3,141270,2275844,106893,20816,13.8,9944,14657,9.7,9939,229889,371159,16.3,60143,195881,302774,13.3,68385,125549,153434,6.2,4.7,26.6
2005,West Virginia,0.9,27024,561025,21045,3867,10.4,2217,3194,8.6,2213,50203,77227,13.8,11307,51255,72300,12.9,4927,29409,37336,4.8,3.8,25.8
2005,Wisconsin,1.3,110272,2430833,89045,12905,10,6916,10086,7.8,6877,207680,317952,13.1,48367,198439,287484,11.8,30468,103727,130102,4.5,3.7,23.6
2005,Wyoming,2.4,11353,187032,7963,2173,12.8,1067,1520,8.9,1067,19163,30516,16.3,5437,18051,26014,13.9,4502,14928,17291,6.1,4.3,27.8
2006,Alabama,3,108950,1676746,80075,10453,11.2,5931,8535,9.1,5906,163658,272608,16.3,42249,142479,222554,13.3,50054,71954,94127,6.5,4.8,26.6
2006,Alaska,4.6,12061,233553,10343,2145,13,1069,1738,10.5,1069,29343,41404,17.7,5605,20243,30586,13.1,10818,13514,16695,5.2,4.4,26.2
2006,Arizona,8.5,179957,2222118,92587,18941,16.4,7780,11445,9.9,7755,277100,457057,20.6,54014,177125,269712,12.1,187345,92344,119297,8.1,4.2,24.2
2006,Arkansas,3.3,58025,1024168,37532,7008,11.8,4130,5708,9.6,4114,92840,150865,14.7,25150,78727,116259,11.4,34606,47017,60099,5.7,3.7,22.8
2006,California,4.3,921350,13386120,640102,104928,13.8,56079,79912,10.5,55919,1473240,2394590,17.9,397172,1185085,1825187,13.6,569403,617167,770688,6.9,4.8,27.2
2006,Colorado,4.8,142727,1950075,98185,18625,14.3,9310,14228,10.9,9292,210138,352865,18.1,60508,161679,259864,13.3,93001,107962,131989,7.3,5,26.6
2006,Connecticut,2.3,76552,1531126,59798,8612,10.3,5306,7724,9.2,5304,134105,210657,13.8,35642,116340,176138,11.5,34519,68481,83902,5,3.9,23
2006,Delaware,-1.3,21131,384702,24686,2553,11.4,1509,2412,10.8,1493,35174,56305,14.6,9499,36547,61233,15.9,-4928,18167,22422,5.5,6.4,29.2
2006,District of Columbia,2,20219,446359,14988,2091,10.9,889,1527,8,883,45852,66071,14.8,7106,42362,57350,12.8,8721,15582,19355,4.5,3.4,25.6
2006,Florida,6.2,510172,6902110,357783,67750,15.5,34386,49324,11.3,34326,841661,1351833,19.6,217924,566387,924170,13.4,427663,360894,444343,7.4,5.2,26.8
2006,Geogia,4.4,247547,3525491,174351,26474,13.6,13168,19790,10.1,13152,373017,620564,17.6,98618,292548,466899,13.2,153665,154619,198160,7,4.9,26.4
2006,Hawaii,4.8,29064,498357,17791,3293,11.1,1540,2258,7.6,1540,48832,77896,15.6,10434,35971,53762,10.8,24134,23743,30034,5.8,3.6,21.6
2006,Idaho,6.2,37401,526510,27317,6128,16.1,2573,3879,10.2,2571,61368,98769,18.8,18990,38799,66116,12.6,32653,32972,39067,7.1,5.2,25.2
2006,Illinois,2.6,297894,5273257,246879,31767,11.3,16856,26528,9.4,16825,510637,808531,15.3,133372,420474,667353,12.7,141178,226308,283645,5.6,4.7,25.4
2006,Indiana,2.7,141904,2626291,102604,14591,10.7,7798,12079,8.9,7765,242193,384097,14.6,60653,209847,312451,11.9,71646,104308,136925,5.4,3.9,23.8
2006,Iowa,2.9,65542,1268988,42444,7748,10.5,4109,6623,9,4109,106389,171931,13.5,27432,91454,133898,10.6,38033,57538,74149,5.2,3.3,21.2
2006,Kansas,2.3,58763,1120068,45358,7293,10.6,4256,6604,9.6,4233,101964,160727,14.3,26678,89470,134828,12,25899,54519,68823,5.2,4,24
2006,Kentucky,2.6,81378,1515778,64945,8851,10.5,5194,7512,8.9,5190,144638,226016,14.9,41128,120888,185833,12.3,40183,65039,84574,5.4,4.3,24.6
2006,Louisiana,-0.7,99278,1572744,95426,9927,10.8,7259,11567,12.5,7253,175316,274594,17.5,51744,191127,286553,18.2,-11959,70851,90863,6.3,6.1,35
2006,Maine,2.3,29962,493834,21713,4229,11.7,2422,3533,9.8,2417,39849,69811,14.1,14079,36375,58088,11.8,11723,30147,36448,6.1,4.4,23.6
2006,Maryland,3.6,127905,2179281,97711,14684,11.9,7547,11418,9.3,7530,222084,349989,16.1,51587,174608,272319,12.5,77670,100089,124696,5.9,4.5,25
2006,Massachusetts,2.8,167204,3012055,122447,16948,10.8,9320,13974,8.9,9313,281361,448565,14.9,66825,242349,364796,12.1,83769,127517,157968,5.6,4.1,24.2
2006,Michigan,1.4,197310,3746234,155837,21887,10.5,13486,20103,9.6,13450,350469,547779,14.6,91161,340264,496101,13.2,51678,164697,209042,5.3,4.2,26.4
2006,Minnesota,2.6,130076,2446297,101618,15152,11.6,7613,12127,9.3,7604,227415,357491,14.6,56714,191880,293498,12,63993,105141,131841,5.3,4.2,24
2006,Mississippi,2.1,56744,925700,42164,6072,11.1,3937,5920,10.8,3932,89916,146660,15.8,25709,85061,127225,13.7,19435,42378,54740,6.1,4.6,27.4
2006,Missouri,2.2,139368,2416727,108230,16145,11.7,10657,15286,11.1,10613,223336,362704,15,63802,201441,309671,12.8,53033,108081,138051,5.8,4.5,25.6
2006,Montana,5.4,25660,328718,16718,4337,14.1,2009,3079,10,2009,34651,60311,18.3,11297,25624,42342,12.9,17969,27004,31409,7.8,5.1,25.8
2006,Nebraska,2.7,42467,778278,27124,4789,10.3,2596,4168,9,2589,65431,107898,13.9,16806,59733,86857,11.2,21041,37422,46581,5.5,3.5,22.4
2006,Nevada,7.7,93095,1113346,52060,8910,17.6,4163,5851,11.6,4160,137066,230161,20.7,33483,92298,144358,13,85803,41777,52023,8.4,4.7,26
2006,New Hampshire,3.1,32360,554098,24186,3952,11.3,2343,3388,9.7,2342,53572,85932,15.5,14464,44430,68616,12.4,17316,28965,35037,5.8,4.4,24.8
2006,New Jersey,2.1,209624,3566348,166471,25502,12,15434,21916,10.3,15420,342954,552578,15.5,89555,312781,479252,13.4,73326,180875,214051,5.9,4.7,26.8
2006,New Mexico,5.9,41252,604139,29401,5040,12.5,2619,3898,9.7,2614,70073,111325,18.4,18882,46298,75699,12.5,35626,32912,40842,6.8,4.9,25
2006,New York,1.7,400454,7431798,341595,53955,11.9,34297,47184,10.4,34251,686993,1087447,14.6,219234,616384,957979,12.9,129468,384889,455004,5.4,4.6,25.8
2006,North Carolina,4,222664,3448872,153612,24326,12.4,12513,18257,9.3,12490,349295,571959,16.6,86009,280713,434325,12.6,137634,153588,198335,6.5,4.5,25.2
2006,North Dakota,3.4,13915,272642,10768,1947,10.4,1000,1674,8.9,1000,25031,38946,14.3,6550,19013,29781,10.9,9165,15382,18823,5.1,3.9,21.8
2006,Ohio,1.8,254924,4756346,208215,24058,9.8,14372,22182,9,14293,424410,679334,14.3,113689,384597,592812,12.5,86522,184406,245668,5.4,4.4,25
2006,Oklahoma,6.4,91281,1234952,54588,9227,11.5,5197,7578,9.5,5167,134734,226015,18.3,32379,92750,147338,11.9,78677,64105,80532,7.4,4.4,23.8
2006,Oregon,3.8,86580,1423618,63190,12706,13.2,6508,9432,9.8,6508,145634,232214,16.3,42900,114207,177397,12.5,54817,79765,97777,6.1,4.4,25
2006,Pennsylvania,2.2,265615,5099144,209206,27512,10,16321,24024,8.7,16148,436299,701914,13.8,130080,382484,591690,11.6,110224,214383,276494,5.2,4.1,23.2
2006,Rhode Island,0.7,23511,435260,16988,3077,11.5,1729,2542,9.5,1724,37304,60815,14,9423,40818,57806,13.3,3009,23301,26983,5.4,3.9,26.6
2006,South Carolina,3.8,97591,1594154,66010,11278,12,6013,8772,9.4,6003,157296,254887,16,40476,128885,194895,12.2,59992,73888,94865,6.1,4.1,24.4
2006,South Dakota,3.9,16249,312906,11549,2472,11.1,1367,2169,9.7,1366,29163,45412,14.5,7775,21648,33197,10.6,12215,18911,22459,5.2,3.7,21.2
2006,Tennessee,4.5,147819,2406681,93568,14215,11.6,7672,11590,9.5,7645,242629,390448,16.2,50756,187654,281222,11.7,109226,92440,123358,6.1,3.9,23.4
2006,Texas,5.1,585359,8369291,408115,57906,12.8,30359,44996,10,30260,953422,1538781,18.4,233183,702331,1110446,13.3,428335,342461,457285,7,4.9,26.6
2006,Utah,6.6,73634,1001326,46827,9500,16.8,4087,6005,10.6,4045,117125,190759,19.1,28691,77990,124817,12.5,65942,47950,58046,7.4,4.7,25
2006,Vermont,1.1,10922,260639,9439,1975,10.1,1220,1781,9.1,1214,20845,31767,12.2,6471,19591,29030,11.1,2737,16957,19687,4.2,3.6,22.2
2006,Virginia,4.3,185777,3086766,126983,21841,12.5,10686,15869,9.1,10672,328765,514542,16.7,68733,256758,383741,12.4,130801,136452,176674,6,4.1,24.8
2006,Washington,4.4,147470,2349985,103112,21238,13.7,10934,16209,10.5,10929,258660,406130,17.3,64051,200579,303691,12.9,102439,128042,157132,6.3,4.4,25.8
2006,West Virginia,3.3,32759,570120,23246,3705,10,2357,3567,9.6,2350,54488,87247,15.3,13822,45109,68355,12,18892,28947,37112,5.7,4.1,24
2006,Wisconsin,1.5,119501,2450218,88864,13345,10.3,7672,11745,9,7666,204458,323959,13.2,55493,197510,286374,11.7,37585,103092,130620,4.9,3.6,23.4
2006,Wyoming,7.1,14712,195009,9023,2279,13.1,1166,1783,10.2,1162,22781,37493,19.2,6251,14594,23617,12.1,13876,15210,17627,7.5,4.6,24.2
2007,Alabama,1.4,102861,1706364,80887,11089,11.6,5685,8667,9.1,5596,172408,275269,16.1,37094,170772,251659,14.7,23610,73242,96526,6,4.7,29.4
2007,Alaska,1.3,15457,240306,11038,2033,12.1,1039,1837,10.9,1028,28790,44247,18.4,4935,29981,41019,17.1,3228,13656,16934,6.4,4.6,34.2
2007,Arizona,2.9,165632,2340144,132846,18072,14.9,8391,13330,11,8323,302881,468513,20,63389,267026,399872,17.1,68641,95367,123760,7.1,5.7,34.2
2007,Arkansas,-0.5,55680,1033247,46143,6730,11.1,3811,5641,9.3,3791,95869,151549,14.7,22436,111142,157285,15.2,-5736,47399,61033,5.4,4.5,29.4
2007,California,0.7,837847,13659650,745596,101437,13.1,55593,86040,11.1,54998,1473827,2311674,16.9,355710,1469050,2214646,16.2,97028,627092,783091,6.1,5.5,32.4
2007,Colorado,2.7,147975,2012974,112071,18667,14,9200,14993,11.2,9137,226202,374177,18.6,56408,207715,319786,15.9,54391,110326,135328,7.4,5.6,31.8
2007,Connecticut,-0.5,83115,1540987,65267,8369,10,4944,7863,9.4,4892,142822,225937,14.7,30111,168316,233583,15.2,-7646,68225,84190,5.4,4.2,29.4
2007,Delaware,0.5,31164,381877,25229,2694,12,1395,2422,10.8,1393,37807,68971,18.1,9682,41995,67224,17.6,1747,18036,22635,8.2,6.6,35.2
2007,District of Columbia,3.8,23757,458077,19376,2141,11,939,1779,9.1,935,52109,75866,16.6,7362,39153,58529,12.8,17337,15704,19667,5.2,4.2,25.6
2007,Florida,0,510170,7087465,451871,65417,14.6,37612,55431,12.4,37329,754843,1265013,17.8,211527,810887,1262758,17.8,2255,365813,452973,7.2,6.4,35.6
2007,Geogia,1.6,234317,3616624,185712,27198,13.5,13539,20972,10.4,13325,381621,615938,17,87990,372010,557722,15.4,58216,158478,203958,6.5,5.1,30.8
2007,Hawaii,1.6,27973,512997,29370,3176,10.5,1657,2804,9.3,1636,53736,81709,15.9,14245,43832,73202,14.3,8507,24062,30378,5.5,5.7,28.6
2007,Idaho,0.8,39109,543932,30962,6021,15.1,2741,4147,10.4,2728,61142,100251,18.4,18595,64878,95840,17.6,4411,34460,40908,7.2,5.7,35.2
2007,Illinois,0.6,280871,5345845,251007,31264,11,16473,27332,9.6,16305,533272,814143,15.2,118854,530757,781764,14.6,32379,228146,287053,5.3,4.7,29.2
2007,Indiana,-0.3,136204,2645792,120018,14395,10.5,7954,12725,9.3,7852,254830,391034,14.8,55931,278555,398573,15.1,-7539,104775,138369,5.1,4.5,29.6
2007,Iowa,0.5,54137,1288325,49728,6890,9.3,3833,6283,8.5,3791,117015,171152,13.3,23021,115342,165070,12.8,6082,57836,74693,4.2,3.9,25.6
2007,Kansas,2,67231,1137885,48195,7297,10.6,4045,6490,9.4,4003,106450,173681,15.3,24045,102787,150982,13.3,22699,54909,69528,5.9,4.2,26.6
2007,Kentucky,0.7,87436,1534537,63467,8789,10.4,4997,7737,9.1,4947,147754,235190,15.3,33849,160898,224365,14.6,10825,65233,85368,5.7,4.1,29.2
2007,Louisiana,4.4,101143,1596659,67152,11565,12.5,4930,7861,8.5,4881,197306,298449,18.7,34515,161483,228635,14.3,69814,74096,94831,6.3,4.2,28.6
2007,Maine,0,28961,497728,26967,4064,11.1,2225,3607,9.8,2216,44343,73304,14.7,13935,46369,73336,14.7,-32,30297,36884,5.8,5.4,29.4
2007,Maryland,0.2,120251,2211202,104321,14143,11.3,7604,12484,10,7541,217363,337614,15.3,47227,229199,333520,15.1,4094,100821,126012,5.4,4.7,30.2
2007,Massachusetts,0.6,132276,3059532,128192,15895,10.1,9189,15206,9.6,9079,297680,429956,14.1,54890,285760,413952,13.5,16004,127388,158399,4.3,4.2,27
2007,Michigan,-2.3,188692,3707476,203336,21334,10.2,13556,21593,10.4,13324,332821,521513,14.1,87461,406266,609602,16.4,-88089,163318,208325,5.1,5.5,28.2
2007,Minnesota,2.5,135793,2499732,110322,14128,10.7,7528,13300,10.1,7473,260285,396078,15.8,50542,222903,333225,13.3,62853,105321,132381,5.4,4.4,26.6
2007,Mississippi,0.3,47866,934203,40660,6511,11.7,3343,5085,9.2,3320,91377,139243,14.9,18920,95935,136595,14.6,2648,43366,56272,5.1,4.4,29.2
2007,Missouri,0.9,127368,2445373,104523,15513,11.2,9383,14104,10.2,9267,237951,365319,14.9,52352,237292,341815,14,23504,108071,139117,5.2,4.3,28
2007,Montana,4.1,22043,344261,15666,4113,12.9,1954,3045,9.5,1931,40465,62508,18.2,9126,32749,48415,14.1,14093,27856,32425,6.4,4.6,28.2
2007,Nebraska,1,37584,789475,29662,4667,10,2500,4077,8.7,2492,73278,110862,14,15152,72581,102243,13,8619,37642,47102,4.8,3.8,26
2007,Nevada,3.7,92579,1167862,60911,8770,16.6,4406,6645,12.5,4383,143603,236182,20.2,30457,132277,193188,16.5,42994,43089,54021,7.9,5.2,33
2007,New Hampshire,0.5,26782,562318,22783,3770,10.7,2244,3484,9.9,2233,52954,79736,14.2,13035,54218,77001,13.7,2735,28918,35212,4.8,4.1,27.4
2007,New Jersey,1,204154,3610285,176524,24482,11.4,15366,23253,10.9,15300,364499,568653,15.8,84378,359089,535613,14.8,33040,180965,214977,5.7,4.9,29.6
2007,New Mexico,3.1,49000,630024,28392,4908,11.9,2491,3935,9.5,2469,66614,115614,18.4,14656,68159,96551,15.3,19063,33451,41765,7.8,4.5,30.6
2007,New York,0.6,399094,7499186,379960,52189,11.4,32022,47542,10.4,31816,719290,1118384,14.9,183250,695397,1075357,14.3,43027,387203,458493,5.3,5.1,28.6
2007,North Carolina,2.2,214550,3539610,164685,25057,12.5,12278,19291,9.6,12116,374803,589353,16.7,79195,349978,514663,14.5,74690,157050,203768,6.1,4.7,29
2007,North Dakota,3.3,17774,283220,11507,1923,10.1,923,1603,8.4,912,28104,45878,16.2,6852,24963,36470,12.9,9408,15645,19170,6.3,4.1,25.8
2007,Ohio,-0.1,248663,4776490,210758,23946,9.8,14011,23300,9.5,13776,429840,678503,14.2,99005,471673,682431,14.3,-3928,182916,245813,5.2,4.4,28.4
2007,Oklahoma,2.3,77023,1282434,61668,9383,11.5,4986,7571,9.3,4940,144494,221517,17.3,32392,130837,192505,15,29012,65032,82232,6,4.8,30
2007,Oregon,1.7,81241,1458850,65546,12340,12.5,6235,9682,9.8,6164,148299,229540,15.7,33884,138846,204392,14,25148,81717,100301,5.6,4.5,28
2007,Pennsylvania,1.1,252168,5161012,219194,27097,9.8,14926,24983,9,14727,484415,736583,14.3,91845,460681,679875,13.2,56708,214521,277520,4.9,4.2,26.4
2007,Rhode Island,1.4,20693,438139,17631,2734,10.1,1763,2715,10.1,1748,41641,62334,14.2,10314,38338,55969,12.8,6365,23132,26964,4.7,4,25.6
2007,South Carolina,1.7,103032,1626298,75528,11744,12.2,6123,9114,9.5,6035,168221,271253,16.7,38306,168767,244295,15,26958,75140,97362,6.3,4.6,30
2007,South Dakota,2,17987,321366,14128,2471,10.9,1233,1994,8.8,1229,30071,48058,15,7420,27631,41759,13,6299,19196,22911,5.6,4.4,26
2007,Tennessee,1.4,137346,2470788,117044,14394,11.6,7498,11806,9.5,7401,273902,411248,16.6,50216,259738,376782,15.2,34466,93687,125759,5.6,4.7,30.4
2007,Texas,4.2,635983,8726014,469560,60291,13,29838,46691,10.1,29483,1062424,1698407,19.5,219750,863674,1333234,15.3,365173,349591,469229,7.3,5.4,30.6
2007,Utah,5.4,70275,1057626,51916,9676,16.2,4026,6319,10.6,4008,136319,206594,19.5,26435,97209,149125,14.1,57469,50829,61337,6.6,4.9,28.2
2007,Vermont,3.4,13145,266249,10705,2029,10.3,1096,1861,9.4,1088,28944,42089,15.8,5047,22262,32967,12.4,9122,17094,19849,4.9,4,24.8
2007,Virginia,0.4,173876,3145819,157480,21084,11.8,10701,17544,9.9,10590,342434,516310,16.4,69289,345990,503470,16,12840,138162,179877,5.5,5,32
2007,Washington,3.8,145357,2439719,119696,21222,13.3,10630,16810,10.6,10561,282864,428221,17.6,57595,215919,335615,13.8,92606,131402,161294,6,4.9,27.6
2007,West Virginia,0.1,32272,578025,25866,3600,9.7,2202,3416,9.2,2163,53399,85671,14.8,14133,59318,85184,14.7,487,28886,37304,5.6,4.5,29.4
2007,Wisconsin,0.7,111864,2470623,90916,12957,9.9,7162,11947,9.1,7085,215104,326968,13.2,44412,218869,309785,12.5,17183,103199,131286,4.5,3.7,25
2007,Wyoming,4.5,12920,205331,10329,2331,13,1110,1691,9.4,1102,25360,38280,18.6,5347,18654,28983,14.1,9297,15690,18238,6.3,5,28.2
2008,Alabama,0.5,78618,1706236,72377,8962,9.3,6235,8375,8.7,6228,157099,235717,13.8,40904,155255,227632,13.3,8085,72666,96133,4.6,4.2,26.6
2008,Alaska,2.3,11169,243073,7369,1859,11,1056,1731,10.3,1055,24773,35942,14.8,5020,23027,30396,12.5,5546,13600,16897,4.6,3,25
2008,Arizona,-2.2,143226,2329160,114421,15715,12.7,10249,14298,11.6,10222,214253,357479,15.3,71871,293954,408375,17.5,-50896,94692,123829,6.1,4.9,30.6
2008,Arkansas,0.1,44767,1022270,33530,5688,9.4,3989,5412,8.9,3979,82766,127533,12.5,22908,92928,126458,12.4,1075,46963,60728,4.4,3.3,24.8
2008,California,0.4,760834,13636472,649961,89808,11.5,59738,83640,10.7,59625,1332441,2093275,15.4,415529,1397705,2047666,15,45609,623470,781622,5.6,4.8,30
2008,Colorado,2.3,123614,2051948,98674,16802,12.4,9833,14839,11,9818,215637,339251,16.5,57149,192373,291047,14.2,48204,110706,136128,6,4.8,28.4
2008,Connecticut,1.8,83030,1540645,55547,7693,9.2,4937,7214,8.6,4936,149035,232065,15.1,31159,149189,204736,13.3,27329,67748,84082,5.4,3.6,26.6
2008,Delaware,1.5,21986,383273,13235,2320,10.3,1536,2255,10,1536,38664,60650,15.8,7615,41528,54763,14.3,5887,17863,22492,5.7,3.5,28.6
2008,District of Columbia,2.4,20445,469428,14915,1968,10,918,1584,8.1,917,42356,62801,13.4,5406,36560,51475,11,11326,15692,19763,4.4,3.2,22
2008,Florida,-1.1,436135,6996652,372201,55755,12.5,43737,59285,13.3,43639,644925,1081060,15.5,238360,791259,1163460,16.6,-82400,356383,444842,6.2,5.3,31
2008,Geogia,0.2,229777,3617140,197189,24133,11.9,15838,22238,11,15827,343567,573344,15.9,102339,369482,566671,15.7,6673,157375,203885,6.4,5.5,31.4
2008,Hawaii,0.3,22223,513837,17302,2689,8.9,1849,2602,8.6,1847,42881,65104,12.7,11532,46414,63716,12.4,1388,23717,30128,4.3,3.4,24.8
2008,Idaho,-1.3,29055,539087,26370,4850,11.9,3333,4694,11.5,3318,46830,75885,14.1,19039,56711,83081,15.4,-7196,33945,40649,5.4,4.9,28.2
2008,Illinois,2.3,262969,5384046,192868,28500,10,17584,26448,9.3,17559,521208,784177,14.6,110403,468151,661019,12.3,123158,226514,286653,4.9,3.6,24.6
2008,Indiana,-0.3,109637,2615628,99837,12301,9,8374,11995,8.7,8371,224071,333708,12.8,60064,244051,343888,13.1,-10180,103458,137213,4.2,3.8,25.6
2008,Iowa,1.7,46812,1294321,39818,6104,8.2,3948,5908,8,3945,115918,162730,12.6,22999,100849,140667,10.9,22063,57371,74301,3.6,3.1,21.8
2008,Kansas,2,47419,1153430,39231,6320,9.1,4083,5826,8.4,4079,108029,155448,13.5,25341,93440,132671,11.5,22777,54540,69315,4.1,3.4,23
2008,Kentucky,1.5,85768,1541639,58822,7540,8.9,5260,7314,8.6,5245,137362,223130,14.5,39214,140939,199761,13,23369,64390,84928,5.6,3.8,26
2008,Louisiana,1.2,78226,1629772,61483,9297,9.8,5607,7724,8.1,5604,161005,239231,14.7,40881,158713,220196,13.5,19035,74463,95650,4.8,3.8,27
2008,Maine,1.2,20837,498135,19474,3469,9.5,2363,3577,9.8,2362,43867,64704,13,12756,39308,58782,11.8,5922,29818,36453,4.2,3.9,23.6
2008,Maryland,0.8,105259,2208003,96296,12209,9.8,8267,12017,9.6,8261,207867,313126,14.2,51635,200138,296434,13.4,16692,99512,124979,4.8,4.4,26.8
2008,Massachusetts,0.7,130541,3059151,107873,14093,9,9362,13769,8.8,9361,263894,394435,12.9,57170,265986,373859,12.2,20576,125940,157417,4.3,3.5,24.4
2008,Michigan,-0.6,180795,3625301,171559,18970,9.2,14031,20189,9.8,13996,328321,509116,14,113506,358287,529846,14.6,-20730,159766,205229,5,4.7,28
2008,Minnesota,0,115541,2517548,89085,12347,9.4,7896,12170,9.3,7894,210840,326381,13,54139,238898,327983,13,-1602,103933,131288,4.6,3.5,26
2008,Mississippi,1.2,42641,935607,36648,5366,9.6,3768,4946,8.8,3767,87188,129829,13.9,23111,82075,118723,12.7,11106,43035,56200,4.6,3.9,25.4
2008,Missouri,1.3,121905,2452162,84171,13371,9.7,9336,12982,9.4,9328,220235,342140,14,51347,226133,310304,12.7,31836,106720,138276,5,3.4,25.4
2008,Montana,2.1,17364,352849,14716,3505,10.8,2152,3180,9.8,2150,34960,52324,14.8,10279,30196,44912,12.7,7412,27792,32458,4.9,4.2,25.4
2008,Nebraska,1.1,32907,794079,24323,4118,8.8,2513,3765,8,2513,71837,104744,13.2,13956,72123,96446,12.1,8298,37467,47090,4.1,3.1,24.2
2008,Nevada,-2.3,73980,1166838,56422,7673,14.2,5147,6837,12.7,5140,104017,177997,15.3,35134,149269,205691,17.6,-27694,42952,54299,6.3,4.8,30.6
2008,New Hampshire,3.8,28588,570408,19002,3251,9.3,2286,3272,9.4,2285,62441,91029,16,12191,50380,69382,12.2,21647,28565,34921,5,3.3,24.4
2008,New Jersey,0,190173,3611772,157381,21852,10.2,16089,22223,10.4,16075,323816,513989,14.2,92558,354110,511491,14.2,2498,178769,213286,5.3,4.4,28.4
2008,New Mexico,1,35380,635396,25971,4388,10.5,2741,3974,9.5,2740,59691,95071,15,16765,62998,88969,14,6102,33434,41824,5.6,4.1,28
2008,New York,1.9,389779,7554581,304836,49839,10.9,31836,43955,9.6,31791,697250,1087029,14.4,196343,640582,945418,12.5,141611,389295,461798,5.2,4,25
2008,North Carolina,1.1,182847,3564766,137177,21338,10.5,13531,18713,9.2,13506,325417,508264,14.3,84991,334931,472108,13.2,36156,156461,204333,5.1,3.8,26.4
2008,North Dakota,2.4,11143,290123,8681,1684,8.8,931,1401,7.3,929,27885,39028,13.5,6858,23620,32301,11.1,6727,15704,19275,3.8,3,22.2
2008,Ohio,-0.6,206401,4729480,197547,19929,8.2,14429,21412,8.8,14400,394178,600579,12.7,106697,431406,628953,13.3,-28374,179209,241853,4.4,4.2,25.4
2008,Oklahoma,2.3,69189,1303599,48119,8511,10.3,5192,7157,8.7,5183,128876,198065,15.2,30666,120164,168283,12.9,29782,65276,82984,5.3,3.7,25.8
2008,Oregon,0.9,68135,1467173,56030,10823,10.8,6940,9755,9.8,6938,133687,201822,13.8,37828,133601,189631,12.9,12191,81599,100461,4.6,3.8,25.8
2008,Pennsylvania,1.5,225487,5192051,170381,24575,8.9,15138,21951,7.9,15121,454611,680098,13.1,99893,430094,600475,11.6,79623,213176,277621,4.3,3.3,23.2
2008,Rhode Island,-0.8,21238,437349,15894,2443,9.1,1777,2692,10.1,1775,33419,54657,12.5,9430,42272,58166,13.3,-3509,22775,26583,4.9,3.6,25
2008,South Carolina,1.2,76753,1636862,57984,9699,10,6510,8945,9.2,6506,158380,235133,14.4,37788,158134,216118,13.2,19015,74452,97154,4.7,3.5,26.4
2008,South Dakota,3.3,15576,326294,11506,2185,9.5,1364,1916,8.4,1360,30456,46032,14.1,7540,23644,35150,10.8,10882,19153,22996,4.8,3.5,21.6
2008,Tennessee,0.5,131254,2478082,89861,13042,10.4,8274,11156,8.9,8262,231444,362698,14.6,59292,258539,348400,14.1,14298,93094,126432,5.3,3.6,28.2
2008,Texas,2.8,564321,8960271,391237,53790,11.5,31288,43439,9.3,31198,964216,1528537,17.1,233904,890224,1281461,14.3,247076,352462,474307,6.3,4.4,28.6
2008,Utah,1.8,56715,1089904,53734,8111,13.2,4921,7035,11.4,4919,123641,180356,16.5,32742,106542,160276,14.7,20080,51292,61940,5.2,4.9,29.4
2008,Vermont,1.2,11833,270929,9336,1724,8.8,1167,1801,9.2,1167,21038,32871,12.1,6398,20245,29581,10.9,3290,16857,19608,4.4,3.4,21.8
2008,Virginia,0.5,154088,3138202,129704,18346,10.3,11747,17198,9.6,11719,303394,457482,14.6,64120,314252,443956,14.1,13526,137392,179167,4.9,4.1,28.2
2008,Washington,1.6,116939,2490976,101205,18980,11.8,11417,16293,10.1,11414,244311,361250,14.5,64943,221134,322339,12.9,38911,131990,162537,4.7,4.1,25.8
2008,West Virginia,0.9,22237,576985,18945,2942,8,2296,3115,8.4,2296,52913,75150,13,11841,50993,69938,12.1,5212,28335,36906,3.9,3.3,24.2
2008,Wisconsin,0.8,92929,2476303,78924,11023,8.5,7504,11024,8.5,7453,199751,292680,11.8,48839,194355,273279,11,19401,101772,130290,3.8,3.2,22
2008,Wyoming,3.8,13141,212960,9552,2065,11.3,1184,1786,9.8,1183,25026,38167,17.9,5696,20480,30032,14.1,8135,15787,18368,6.2,4.5,28.2
2009,Alabama,-5.6,65304,1649880,65259,7519,8,6723,9425,10,6704,109719,175023,10.6,36116,202128,267387,16.2,-92364,70162,93377,4,4,21.2
2009,Alaska,1.7,12482,246886,10636,1716,10.2,1039,1793,10.7,1019,26846,39328,15.9,5174,24436,35072,14.2,4256,13338,16708,5.1,4.3,28.4
2009,Arizona,-8.8,114252,2190657,148847,12483,10.4,11496,16725,13.9,11454,157032,271284,12.4,68743,314489,463336,21.2,-192052,89209,117975,5.2,6.8,24.8
2009,Arkansas,-5,41703,992135,42965,5128,8.6,4134,5798,9.7,4122,65880,107583,10.8,23510,113993,156958,15.8,-49375,45818,59583,4.2,4.3,21.6
2009,California,-6,617777,13152313,650592,77068,10,62503,90213,11.7,62297,955015,1572792,12,369291,1713517,2364109,18,-791317,603592,760096,4.7,4.9,24
2009,Colorado,-4.6,100849,2015038,107228,13980,10.5,10604,16450,12.3,10587,158738,259587,12.9,63864,245742,352970,17.5,-93383,107011,132203,5,5.3,25.8
2009,Connecticut,-5.1,52952,1507128,56524,6257,7.6,5150,7969,9.6,5128,100620,153572,10.2,30772,174325,230849,15.3,-77277,65542,81635,3.5,3.8,20.4
2009,Delaware,-3.5,20950,375756,15751,2000,9.1,1459,2362,10.7,1457,24523,45473,12.1,7739,42911,58662,15.6,-13189,17272,21873,5.6,4.2,24.2
2009,District of Columbia,0.7,18703,474864,13643,1836,9.3,939,1713,8.7,936,41662,60365,12.7,5809,43356,56999,12,3366,15523,19694,3.9,2.9,24
2009,Florida,-6.7,366334,6675773,362522,48630,11.2,42873,61236,14.1,42645,479233,845567,12.7,217397,935747,1298269,19.4,-452702,339120,426736,5.5,5.4,25.4
2009,Geogia,-5.9,183760,3484607,182777,19402,9.7,17357,24941,12.5,17251,247212,430972,12.4,110720,455110,637887,18.3,-206915,149668,195693,5.3,5.2,24.8
2009,Hawaii,-5.3,19860,497508,18661,2413,8.1,1852,2722,9.1,1848,30551,50411,10.1,10453,57977,76638,15.4,-26227,23197,29631,4,3.8,20.2
2009,Idaho,-6.8,23916,514604,25244,3623,9.2,3463,5315,13.4,3463,33209,57125,11.1,16011,67070,92314,17.9,-35189,31896,38562,4.6,4.9,22.2
2009,Illinois,-5.9,204167,5258092,217824,24157,8.6,18358,29069,10.3,18307,339684,543851,10.3,115899,633815,851639,16.2,-307788,219962,279176,3.9,4.1,20.6
2009,Indiana,-5.9,91730,2517770,99904,10175,7.5,8449,12758,9.5,8376,176663,268393,10.7,50973,318964,418868,16.6,-150475,100048,133404,3.6,4,21.4
2009,Iowa,-2.2,44560,1285871,37308,5203,7.1,3986,5908,8,3982,96028,140588,10.9,24510,131350,168658,13.1,-28070,56255,73156,3.5,2.9,21.8
2009,Kansas,-2.7,41895,1143428,37779,5245,7.7,4171,6080,8.9,4163,84159,126054,11,24629,118791,156570,13.7,-30516,53274,67992,3.7,3.3,22
2009,Kentucky,-4.5,60790,1507615,54014,6671,8,5229,7578,9,5205,103269,164059,10.9,30803,178353,232367,15.4,-68308,62735,83313,4,3.6,21.8
2009,Louisiana,-0.6,71686,1626084,60317,7926,8.3,5699,8085,8.5,5698,140011,211697,13,34714,161246,221563,13.6,-9866,73649,94936,4.4,3.7,26
2009,Maine,-3.8,17513,489262,17675,2819,7.9,2379,3763,10.5,2378,32781,50294,10.3,11482,51554,69229,14.1,-18935,28598,35206,3.6,3.6,20.6
2009,Maryland,-4,86147,2158142,90153,10545,8.6,8245,12771,10.4,8212,158771,244918,11.3,46629,240578,330731,15.3,-85813,95892,121538,4,4.2,22.6
2009,Massachusetts,-3.4,105364,2995655,106166,12166,7.9,9378,14787,9.5,9322,202549,307913,10.3,55799,303936,410102,13.7,-102189,121876,153232,3.5,3.5,20.6
2009,Michigan,-6.7,144970,3478306,164632,15710,7.8,13854,21855,10.9,13799,256280,401250,11.5,98250,467633,632265,18.2,-231015,153290,197404,4.2,4.7,23
2009,Minnesota,-5.1,89141,2442668,88814,10732,8.3,7804,12828,9.9,7764,176196,265337,10.9,52176,301549,390363,16,-125026,100846,128178,3.6,3.6,21.8
2009,Mississippi,-4.3,45076,916080,38165,4471,8.1,3767,5237,9.4,3749,59556,104632,11.4,22065,105275,143440,15.7,-38808,41861,55013,4.9,4.2,22.8
2009,Missouri,-4.3,93957,2401047,104372,11423,8.4,9693,14007,10.3,9675,172874,266831,11.1,59326,265311,369683,15.4,-102852,103325,134648,3.9,4.3,22.2
2009,Montana,-5,12305,346462,15132,2763,8.7,2267,3687,11.6,2267,26792,39097,11.3,8893,41272,56404,16.3,-17307,26670,31254,3.6,4.4,22.6
2009,Nebraska,-2.6,29063,786544,29951,3631,7.8,2469,3811,8.2,2462,55992,85055,10.8,14972,75700,105651,13.4,-20596,37043,46618,3.7,3.8,21.6
2009,Nevada,-9.7,59324,1091256,57168,6517,12.3,5445,7632,14.4,5413,79386,138710,12.7,35587,187530,244698,22.4,-105988,41072,52478,5.4,5.2,25.4
2009,New Hampshire,-4.4,18977,567450,21416,2765,8.1,2331,3579,10.4,2326,39693,58670,10.3,11749,62070,83486,14.7,-24816,27521,33799,3.3,3.8,20.6
2009,New Jersey,-5.5,143706,3492410,160696,18642,8.9,16552,24053,11.5,16514,248797,392503,11.2,93382,423550,584246,16.7,-191743,171218,205730,4.1,4.6,22.4
2009,New Mexico,-4,25829,621597,26660,3562,8.7,3001,4304,10.5,2997,48326,74155,11.9,15604,72166,98826,15.9,-24671,32272,40705,4.2,4.3,23.8
2009,New York,-3.4,307453,7462859,290803,45488,9.9,33219,48469,10.6,33153,527788,835241,11.2,176848,799935,1090738,14.6,-255497,383366,456158,4.1,3.9,22.4
2009,North Carolina,-5.8,148087,3449936,143616,17508,8.7,15121,21888,10.9,15069,218621,366708,10.6,80082,423051,566667,16.4,-199959,149439,197716,4.3,4.2,21.2
2009,North Dakota,-0.7,11912,291350,11345,1505,7.8,958,1508,7.9,957,23157,35069,12,7038,25775,37120,12.7,-2051,15624,19170,4.1,3.9,24
2009,Ohio,-5.2,181103,4564712,187003,17359,7.3,14499,22159,9.3,14307,305156,486259,10.7,100080,537468,724471,15.9,-238212,172788,234803,4,4.1,21.4
2009,Oklahoma,-2.4,57140,1295431,58167,7298,8.9,5245,7376,8.9,5236,101929,159069,12.3,35080,132085,190252,14.7,-31183,64651,82358,4.4,4.5,24.6
2009,Oregon,-7.5,54402,1414710,61250,8699,8.8,7734,11408,11.6,7722,97133,151535,10.7,34388,195541,256791,18.2,-105256,77779,96649,3.8,4.3,21.4
2009,Pennsylvania,-3.4,177554,5112881,190880,20912,7.6,15143,23435,8.5,15000,349169,526723,10.3,97546,509788,700668,13.7,-173945,208835,273060,3.5,3.7,20.6
2009,Rhode Island,-4.8,14222,420374,19742,1978,7.6,1876,2895,11.2,1875,30683,44905,10.7,12364,45539,65281,15.5,-20376,21652,25369,3.4,4.7,21.4
2009,South Carolina,-6.4,74027,1584474,70560,8234,8.6,7352,10485,11,7269,99863,173890,11,39164,204428,274988,17.4,-101098,71286,93904,4.7,4.5,22
2009,South Dakota,-1.4,13765,328010,11923,1906,8.3,1330,1994,8.7,1330,24639,38404,11.7,7702,31076,42999,13.1,-4595,18901,22752,4.2,3.6,23.4
2009,Tennessee,-6.7,95798,2386233,98936,10414,8.4,8719,12494,10.1,8676,159967,255765,10.7,58061,316745,415681,17.4,-159916,89911,123069,4,4.1,21.4
2009,Texas,-2.7,478943,8908457,392950,47938,10.2,32203,46739,9.9,31994,733767,1212710,13.6,213008,1062608,1455558,16.3,-242848,348661,471556,5.4,4.4,27.2
2009,Utah,-4.5,50969,1070249,56130,6838,11.3,5714,8466,14,5711,90808,141777,13.2,32281,133063,189193,17.7,-47416,48715,59643,4.8,5.2,26.4
2009,Vermont,-2.7,11153,267430,10115,1527,7.9,1181,1893,9.8,1175,17320,28473,10.6,5266,25558,35673,13.3,-7200,16258,19070,4.2,3.8,21.2
2009,Virginia,-3.5,147830,3068091,126001,16294,9.2,12138,18132,10.2,12110,221504,369334,12,66668,350618,476619,15.5,-107285,133184,175757,4.8,4.1,24
2009,Washington,-5.1,100028,2434700,109870,15081,9.5,12865,19196,12,12846,209907,309935,12.7,63786,323049,432919,17.8,-122984,126072,156869,4.1,4.5,25.4
2009,West Virginia,-1.2,22253,573846,17025,2651,7.3,2161,3038,8.3,2159,44792,67045,11.7,10657,57187,74212,12.9,-7167,27556,36314,3.9,3,23.4
2009,Wisconsin,-4.6,73841,2413196,84741,9495,7.4,7535,11599,9,7519,147007,220848,9.2,46369,249292,334033,13.8,-113185,98835,127318,3.1,3.5,18.4
2009,Wyoming,-3.1,9117,211114,9584,1772,9.7,1256,1831,10,1255,19097,28214,13.4,5876,25300,34884,16.5,-6670,15567,18185,4.3,4.5,26.8
2010,Alabama,-2.4,61672,1575651,63404,7236,7.9,5891,8278,9,5861,115251,176923,11.2,40694,150626,214030,13.6,-37107,68309,91611,3.9,4,22.4
2010,Alaska,1.2,9272,249695,7519,1648,9.8,849,1448,8.6,841,24863,34135,13.7,4196,23812,31331,12.5,2804,13381,16841,3.7,3,25
2010,Arizona,-2.3,123771,2056376,101831,12266,10.6,9345,13916,12,9288,168967,292738,14.2,54758,237023,338854,16.5,-46116,86469,115033,6,5,28.4
2010,Arkansas,-0.1,43056,959779,32560,4956,8.4,3482,5061,8.5,3479,73635,116691,12.2,21039,85674,118234,12.3,-1543,45330,59242,4.5,3.4,24.4
2010,California,-2.7,581224,12463214,580226,74886,10,54411,80810,10.8,54251,973388,1554612,12.5,339689,1315287,1895513,15.2,-340901,591475,747282,4.7,4.7,25
2010,Colorado,-2.1,101267,1940711,91109,14136,10.8,9352,15187,11.6,9340,162891,264158,13.6,50323,212898,304007,15.7,-39849,105043,130161,5.2,4.7,27.2
2010,Connecticut,-1.6,51596,1448532,47389,6315,7.8,4515,7009,8.7,4509,103558,155154,10.7,28282,131057,178446,12.3,-23292,64300,80366,3.6,3.3,21.4
2010,Delaware,-2.4,15812,362546,14943,1905,8.8,1293,2151,10,1293,24877,40689,11.2,6802,34542,49485,13.6,-8796,17005,21470,4.4,4.1,22.4
2010,District of Columbia,0.3,19764,475054,13527,1948,9.9,880,1618,8.2,879,38075,57839,12.2,5860,42977,56504,11.9,1335,15585,19921,4.2,2.8,23.8
2010,Florida,-0.3,394858,6402324,325938,50482,11.9,34794,51611,12.2,34729,576324,971182,15.2,190846,667502,993440,15.5,-22258,336332,423077,6.2,5.1,30.4
2010,Geogia,-1.5,163902,3334780,148651,18983,9.8,13897,21224,11,13860,261749,425651,12.8,86003,328808,477459,14.3,-51808,146487,192051,4.9,4.5,25.6
2010,Hawaii,-1.8,21209,478938,19619,2321,7.9,1645,2596,8.9,1644,34690,55899,11.7,11002,45240,64859,13.5,-8960,22764,29173,4.4,4.1,23.4
2010,Idaho,-1.6,23135,491316,20022,3733,9.8,2772,4318,11.3,2761,42355,65490,13.3,12104,53120,73142,14.9,-7652,31109,37767,4.7,4.1,26.6
2010,Illinois,-2.5,196508,5014064,191358,24500,8.9,15687,25964,9.4,15636,353636,550144,11,104173,487244,678602,13.5,-128458,216836,275846,3.9,3.8,22
2010,Indiana,-1.9,82856,2407414,85078,9967,7.5,7136,11004,8.3,7121,186936,269792,11.2,52199,229296,314374,13.1,-44582,98223,131554,3.4,3.5,22.4
2010,Iowa,-1.6,39343,1256675,39006,5189,7.1,3330,5224,7.2,3324,89303,128646,10.2,24860,109710,148716,11.8,-20070,55740,72787,3.1,3.1,20.4
2010,Kansas,-2.2,39340,1112150,40209,5150,7.6,3651,5507,8.2,3639,80232,119572,10.8,21631,103905,144114,13,-24542,52476,67257,3.5,3.6,21.6
2010,Kentucky,-1.3,62695,1455388,51005,6557,7.9,4604,7015,8.5,4595,108036,170731,11.7,31448,138508,189513,13,-18782,61703,82367,4.3,3.5,23.4
2010,Louisiana,-2.2,66495,1597064,54274,7837,8.3,5194,7619,8.1,5180,119144,185639,11.6,34842,165794,220068,13.8,-34429,73129,94735,4.2,3.4,23.2
2010,Maine,-1.4,19651,474718,16923,3044,8.7,1854,3098,8.8,1854,31892,51543,10.9,9039,41396,58319,12.3,-6776,28322,35009,4.1,3.6,21.8
2010,Maryland,-2,83263,2090295,78165,10560,8.8,7003,11543,9.6,6976,163611,246874,11.8,40165,210236,288401,13.8,-41527,94482,119965,4,3.7,23.6
2010,Massachusetts,-0.9,109569,2909517,89991,12824,8.4,8215,13164,8.7,8183,220839,330408,11.4,50162,267868,357859,12.3,-27451,120173,151804,3.8,3.1,22.8
2010,Michigan,-2.2,130494,3308320,136640,15361,7.9,11583,18291,9.4,11572,270218,400712,12.1,78427,336148,472788,14.3,-72076,149650,193215,3.9,4.1,24.2
2010,Minnesota,-0.8,95094,2362890,86362,10649,8.4,6569,11055,8.7,6568,175104,270198,11.4,42835,202583,288945,12.2,-18747,99643,127073,4,3.7,22.8
2010,Mississippi,-1.8,34658,882239,28934,4407,8.1,3216,4596,8.4,3209,61657,96315,10.9,18548,83134,112068,12.7,-15753,41317,54554,3.9,3.3,21.8
2010,Missouri,-2.2,92617,2310166,79042,12186,9.1,8403,12479,9.4,8379,166822,259439,11.2,47758,230245,309287,13.4,-49848,101878,133147,4,3.4,22.4
2010,Montana,-0.7,15389,335519,11351,2804,9,1853,3035,9.8,1853,26030,41419,12.3,7397,32312,43663,13,-2244,26282,30891,4.6,3.4,24.6
2010,Nebraska,-0.9,27158,769497,19562,3674,7.9,2105,3409,7.3,2092,53066,80224,10.4,11677,67561,87123,11.3,-6899,36994,46715,3.5,2.5,20.8
2010,Nevada,-3.3,68698,1013982,49641,6350,12.3,4676,6770,13.1,4669,77855,146553,14.5,32802,130534,180175,17.8,-33622,40049,51504,6.8,4.9,29
2010,New Hampshire,0.3,22391,553824,17976,2809,8.4,1930,2944,8.8,1924,47580,69971,12.6,10615,50258,68234,12.3,1737,27162,33438,4,3.2,24.6
2010,New Jersey,-1.5,144497,3352898,146853,18711,9.2,13952,21516,10.6,13922,257094,401591,12,81792,305290,452143,13.5,-50552,167736,201598,4.3,4.4,24
2010,New Mexico,-2.1,24024,600779,21523,3349,8.3,2629,3992,9.9,2628,46889,70913,11.8,13648,61915,83438,13.9,-12525,31456,39840,4,3.6,23.6
2010,New York,-0.7,328215,7283366,290714,47571,10.4,30422,44876,9.8,30381,558709,886924,12.2,174791,646055,936769,12.9,-49845,384271,457218,4.5,4,24.4
2010,North Carolina,-2.3,153690,3288940,134134,18243,9.3,12368,19561,10,12322,249147,402837,12.2,71388,341981,476115,14.5,-73278,147065,195119,4.7,4.1,24.4
2010,North Dakota,1.2,10719,290680,7710,1584,8.2,784,1308,6.8,784,24071,34790,12,3998,23594,31304,10.8,3486,15814,19404,3.7,2.7,21.6
2010,Ohio,-1.9,166757,4373318,145983,17044,7.4,11915,19230,8.3,11890,312362,479119,11,86081,418198,564181,12.9,-85062,168776,230640,3.8,3.3,22
2010,Oklahoma,-3.2,58138,1251827,49877,6874,8.4,4816,7061,8.6,4800,84276,142414,11.4,30769,132555,182432,14.6,-40018,63978,81768,4.6,4,22.8
2010,Oregon,-0.6,59281,1349219,52576,9212,9.6,6219,9585,10,6188,118334,177615,13.2,34799,133238,185814,13.8,-8199,76540,95661,4.4,3.9,26.4
2010,Pennsylvania,-1.3,193819,4969707,182054,20746,7.7,13456,21591,8,13440,362058,555877,11.2,103895,439211,621265,12.5,-65388,206047,270631,3.9,3.7,22.4
2010,Rhode Island,-3.1,16896,401793,13335,2197,8.7,1550,2382,9.5,1550,25605,42501,10.6,8554,41526,54861,13.7,-12360,21240,25045,4.2,3.3,21.2
2010,South Carolina,-2,72804,1502711,55154,8144,8.8,6125,9065,9.8,6080,110081,182885,12.2,34737,158480,213634,14.2,-30749,69779,92474,4.8,3.7,24.4
2010,South Dakota,-0.9,13077,322349,10753,1870,8.2,1109,1735,7.6,1109,23453,36530,11.3,7094,28427,39180,12.2,-2650,18888,22818,4.1,3.3,22.6
2010,Tennessee,-1.7,93997,2271366,86353,10128,8.3,7494,10980,9,7468,177243,271240,11.9,51605,222392,308745,13.6,-37505,88094,121225,4.1,3.8,23.8
2010,Texas,-1,479146,8701186,375722,47216,10,29348,43204,9.2,29270,727523,1206669,13.9,214455,923606,1299328,14.9,-92659,348248,472374,5.5,4.3,27.8
2010,Utah,-3.4,51952,1024126,47369,6933,11.7,4684,7209,12.2,4662,77772,129724,12.7,30049,117487,164856,16.1,-35132,48045,58940,5.1,4.6,25.4
2010,Vermont,-0.9,8709,262339,7394,1482,7.8,967,1570,8.3,961,17065,25774,9.8,4784,20574,27968,10.7,-2194,16094,18929,3.3,2.8,19.6
2010,Virginia,-1.1,134071,2972940,125844,15688,9,10160,16266,9.3,10130,242192,376263,12.7,62347,285187,411031,13.8,-34768,131474,174051,4.5,4.2,25.4
2010,Washington,-2.7,108722,2331154,91745,15275,9.8,10489,16049,10.3,10454,167704,276426,11.9,52036,249190,340935,14.6,-64509,124320,155140,4.7,3.9,23.8
2010,West Virginia,-2,21986,562235,19931,2459,6.8,1905,2831,7.9,1885,42111,64097,11.4,12372,55576,75507,13.4,-11410,26884,35741,3.9,3.5,22.8
2010,Wisconsin,-1.7,76122,2326373,73668,9295,7.4,6371,10021,7.9,6366,153820,229942,9.9,42665,195072,268740,11.6,-38798,97188,125869,3.3,3.2,19.8
2010,Wyoming,-4.4,8185,201268,8518,1547,8.6,1158,1815,10.1,1158,15166,23351,11.6,4821,23770,32288,16,-8937,15163,17795,4.1,4.2,23.2
2011,Alabama,0.8,64020,1553149,53261,7308,8.1,5393,7951,8.8,5369,127830,191850,12.4,29016,126182,179443,11.6,12407,67013,90232,4.1,3.4,23.2
2011,Alaska,0.3,10061,251986,8420,1642,9.7,861,1492,8.8,856,21615,31676,12.6,4102,22582,31002,12.3,674,13339,16965,4,3.3,24.6
2011,Arizona,2.5,106373,2048945,88718,12639,11.1,8492,12809,11.2,8445,209645,316018,15.4,53681,175038,263756,12.9,52262,85339,114040,5.2,4.3,25.8
2011,Arkansas,1.5,41156,962552,33699,5109,8.7,3525,5139,8.7,3510,83067,124223,12.9,20023,76229,109928,11.4,14295,44767,58774,4.3,3.5,22.8
2011,California,1.8,573390,12340963,530777,79745,10.7,49745,74294,10,49559,1177698,1751088,14.2,307002,998758,1529535,12.4,221553,590584,748458,4.6,4.3,24.8
2011,Colorado,1.6,94578,1926868,80449,14530,11.2,8744,14018,10.8,8734,184631,279209,14.5,48221,168093,248542,12.9,30667,104338,129760,4.9,4.2,25.8
2011,Connecticut,0.7,52051,1437538,48349,6281,7.9,4370,6889,8.6,4362,111283,163334,11.4,23570,105954,154303,10.7,9031,63236,79287,3.6,3.4,21.4
2011,Delaware,-0.1,13549,357296,14130,1920,9,1222,2018,9.5,1222,29861,43410,12.1,6347,29614,43744,12.2,-334,16787,21191,3.8,4,24.2
2011,District of Columbia,3.1,18491,482205,11434,1866,9.3,823,1482,7.4,823,44416,62907,13,6430,36189,47623,9.9,15284,15706,20165,3.8,2.4,19.8
2011,Florida,2.3,406432,6460908,349482,53493,12.6,33209,49052,11.6,33118,664106,1070538,16.6,190027,575990,925472,14.3,145066,337537,425180,6.3,5.4,28.6
2011,Geogia,0.8,155931,3298519,154434,19555,10.3,13057,19705,10.3,13020,302138,458069,13.9,82720,276185,430619,13.1,27450,144809,190576,4.7,4.7,26.2
2011,Hawaii,1.5,19386,476669,15970,2335,8.1,1627,2390,8.3,1623,38454,57840,12.1,9448,34435,50405,10.6,7435,22388,28869,4.1,3.4,21.2
2011,Idaho,-0.9,20350,483705,20837,3581,9.6,2660,4220,11.3,2652,40968,61318,12.7,13905,44911,65748,13.6,-4430,30134,36806,4.2,4.3,25.4
2011,Illinois,1.6,200466,4969298,166807,26068,9.5,15544,24939,9.1,15366,425185,625651,12.6,95503,378763,545570,11,80081,215800,275240,4,3.4,22
2011,Indiana,1.9,87223,2398400,76414,10642,8.2,7043,10709,8.2,7009,207386,294609,12.3,46968,173573,249987,10.4,44622,96669,130392,3.6,3.2,20.8
2011,Iowa,1.6,40358,1252562,33157,5346,7.4,3428,5444,7.5,3419,100169,140527,11.2,19369,87341,120498,9.6,20029,55092,72304,3.2,2.6,19.2
2011,Kansas,0,47391,1096570,38419,5444,8.2,3768,5672,8.5,3766,84294,131685,12,22733,93364,131783,12,-98,51402,66564,4.3,3.5,24
2011,Kentucky,0.7,54147,1444962,50692,6575,8,4695,6802,8.3,4683,120134,174281,12.1,30695,114297,164989,11.4,9292,60544,81479,3.7,3.5,22.8
2011,Louisiana,1.4,70584,1587766,52480,7994,8.5,5268,7622,8.1,5252,138549,209133,13.2,30919,134511,186991,11.8,22142,72574,94665,4.4,3.3,23.6
2011,Maine,0.2,18599,469665,16984,2998,8.6,1907,3235,9.3,1903,34586,53185,11.3,10301,35232,52216,11.1,969,27836,34526,4,3.6,22.2
2011,Maryland,1.8,90617,2079515,66228,10884,9.1,6785,10646,8.9,6781,182477,273094,13.1,38022,169548,235776,11.3,37318,93326,119320,4.4,3.2,22.6
2011,Massachusetts,1.3,96314,2902293,81204,13117,8.7,7631,12237,8.1,7624,235214,331528,11.4,42670,212505,293709,10.1,37819,119684,151698,3.3,2.8,20.2
2011,Michigan,3.5,126206,3316652,118848,16662,8.7,10597,16624,8.6,10566,353217,479423,14.5,71827,247524,366372,11,113051,148091,192152,3.8,3.6,22
2011,Minnesota,2.2,86391,2373328,70902,11038,8.7,6623,10755,8.5,6604,197869,284260,12,42796,162291,233193,9.8,51067,98958,126765,3.6,3,19.6
2011,Mississippi,0.9,36121,875789,28771,4370,8.1,3121,4427,8.2,3115,66570,102691,11.7,17698,65764,94535,10.8,8156,40741,54116,4.1,3.3,21.6
2011,Missouri,0.2,82304,2279005,74203,11952,9.1,8920,12657,9.6,8914,176074,258378,11.3,47117,177721,251924,11.1,6454,99809,131606,3.6,3.3,22.2
2011,Montana,-1.3,12554,332629,16311,2883,9.4,1881,3087,10.1,1872,27497,40051,12,11434,28001,44312,13.3,-4261,25815,30437,3.8,4.9,24
2011,Nebraska,-0.7,27090,759973,33154,3788,8.1,2314,3693,7.9,2308,59755,86845,11.4,13516,59103,92257,12.1,-5412,36588,46481,3.6,4.4,22.8
2011,Nevada,-0.1,46742,992737,45916,6384,12.4,4262,6084,11.9,4235,86581,133323,13.4,32216,88435,134351,13.5,-1028,39829,51417,4.7,4.6,26.8
2011,New Hampshire,-1.5,16970,548780,17930,2685,8.1,1924,2883,8.7,1924,40287,57257,10.4,11192,47520,65450,11.9,-8193,26731,33030,3.1,3.3,20.8
2011,New Jersey,1,141465,3329964,126943,19768,9.9,13343,19913,9.9,13313,288123,429588,12.9,72524,269976,396919,11.9,32669,166309,200448,4.2,3.8,23.8
2011,New Mexico,0.2,24117,594037,18773,3615,9.1,2461,3622,9.1,2456,48188,72305,12.2,12203,52241,71014,12,1291,31031,39592,4.1,3.2,24
2011,New York,1.8,321549,7297157,281166,48755,10.7,30525,45135,9.9,30479,636775,958324,13.1,166997,544978,826144,11.3,132180,385117,459053,4.4,3.9,22.6
2011,North Carolina,2,139388,3264355,111297,17930,9.3,12248,18251,9.4,12172,288277,427665,13.1,70369,249927,361224,11.1,66441,144978,193170,4.3,3.4,22.2
2011,North Dakota,2.8,12781,295747,8623,1856,9.5,928,1442,7.4,926,25890,38671,13.1,5748,21923,30546,10.3,8125,15966,19700,4.3,2.9,20.6
2011,Ohio,2.2,156176,4357379,133746,17683,7.7,11490,18409,8,11430,395602,551778,12.7,78508,325361,459107,10.5,92671,166689,228282,3.6,3.1,21
2011,Oklahoma,1.9,51579,1238630,45383,7173,8.8,4905,7056,8.7,4891,113395,164974,13.3,28940,95730,141113,11.4,23861,63234,81323,4.2,3.7,22.8
2011,Oregon,0.3,49739,1333135,48486,9196,9.7,6015,9140,9.6,5971,121962,171701,12.9,29732,119510,167996,12.6,3705,75853,95050,3.7,3.6,25.2
2011,Pennsylvania,2.2,197565,4968181,152980,21855,8.1,12985,20298,7.5,12955,422680,620245,12.5,84518,358222,511202,10.3,109043,204451,270195,4,3.1,20.6
2011,Rhode Island,2.5,14790,399466,12855,2177,8.8,1431,2266,9.1,1428,34460,49250,12.3,6613,26191,39046,9.8,10204,20958,24814,3.7,3.2,19.6
2011,South Carolina,1.4,64008,1491568,56312,7963,8.7,5886,8667,9.5,5869,135127,199135,13.4,36245,122372,178684,12,20451,68279,91070,4.3,3.8,24
2011,South Dakota,-0.6,13067,319150,13447,1850,8.1,1202,1854,8.2,1193,23975,37042,11.6,9527,25587,39034,12.2,-1992,18673,22699,4.1,4.2,23.2
2011,Tennessee,1.8,81799,2261749,83132,10255,8.5,7436,10717,8.9,7370,210006,291805,12.9,46629,167465,250597,11.1,41208,86652,119647,3.6,3.7,22.2
2011,Texas,2.5,455216,8725992,336430,49385,10.5,29905,43344,9.2,29737,858942,1314158,15.1,206349,763726,1100156,12.6,214002,348526,475059,5.2,3.9,25.2
2011,Utah,1.3,50588,1010121,40212,6945,11.8,4198,6445,11,4179,89162,139750,13.8,26514,85817,126029,12.5,13721,47970,59067,5,4,25
2011,Vermont,0.6,7659,261283,7889,1468,7.8,1048,1674,8.9,1044,19688,27347,10.5,4666,17859,25748,9.9,1599,15835,18631,2.9,3,19.8
2011,Virginia,1.5,134609,2962845,105220,16468,9.5,10252,15775,9.1,10228,267853,402462,13.6,59331,252368,357588,12.1,44874,129895,173214,4.5,3.6,24.2
2011,Washington,-0.5,97893,2283205,113095,15335,10,10586,16264,10.6,10567,212112,310005,13.6,52444,208226,321321,14.1,-11316,121993,152946,4.3,5,27.2
2011,West Virginia,1,18403,555542,16719,2621,7.4,1962,2824,8,1961,47322,65725,11.8,11291,43485,60204,10.8,5521,26243,35267,3.3,3,21.6
2011,Wisconsin,1.5,72295,2316296,62461,9224,7.4,6361,10019,8,6324,184574,256869,11.1,38882,158748,221209,9.6,35660,95468,124286,3.1,2.7,19.2
2011,Wyoming,1.9,9200,198960,7674,1799,10.1,1029,1631,9.2,1029,19895,29095,14.6,4610,17647,25321,12.7,3774,15218,17900,4.6,3.9,25.4
2012,Alabama,1,61103,1560918,57908,7896,8.8,4835,7593,8.4,4781,141263,202366,13,30569,129370,187278,12,15088,67040,90410,3.9,3.7,24
2012,Alaska,1.7,12646,254120,8240,1742,10.2,789,1618,9.5,782,27092,39738,15.6,3692,27178,35418,13.9,4320,13511,17129,5,3.2,27.8
2012,Arizona,1.9,110836,2085298,97214,12839,11.3,7329,12008,10.5,7236,218716,329552,15.8,42669,192419,289633,13.9,39919,85908,114681,5.3,4.7,27.8
2012,Arkansas,0.1,35285,967495,37716,5117,8.7,3166,4998,8.5,3128,86295,121580,12.6,18739,83090,120806,12.5,774,44996,58976,3.6,3.9,25
2012,California,2.4,593971,12562400,547326,84324,11.2,45970,74867,10,45546,1308057,1902028,15.1,277550,1049410,1596736,12.7,305292,600518,758097,4.7,4.4,25.4
2012,Colorado,3.1,99671,1967362,82962,14968,11.5,7832,13521,10.4,7756,199470,299141,15.2,40588,155969,238931,12.1,60210,105729,131110,5.1,4.2,24.2
2012,Connecticut,2.7,52856,1459539,48708,7075,8.9,3929,6541,8.2,3899,144423,197279,13.5,22776,108468,157176,10.8,40103,63690,79786,3.6,3.3,21.6
2012,Delaware,1.8,18310,359730,19387,2181,10.3,1158,2031,9.6,1151,33536,51846,14.4,6259,25956,45343,12.6,6503,16757,21303,5.1,5.4,25.2
2012,District of Columbia,2.1,18326,489072,14703,1791,8.9,835,1690,8.4,823,47885,66211,13.5,6521,40946,55649,11.4,10562,15848,20144,3.7,3,22.8
2012,Florida,3.3,381064,6631502,371051,55709,13,29020,45371,10.6,28696,735804,1116868,16.8,211495,522490,893541,13.5,223327,347336,435977,5.7,5.6,27
2012,Geogia,2,171518,3330625,154181,21132,11.1,11651,19523,10.2,11546,321952,493470,14.8,68040,273130,427311,12.8,66159,146087,192068,5.1,4.6,25.6
2012,Hawaii,2.5,19637,485956,16954,2351,8.2,1401,2445,8.5,1392,41730,61367,12.6,7073,32038,48992,10.1,12375,22387,28754,4,3.5,20.2
2012,Idaho,2.5,26324,487577,25341,3983,10.8,2253,3744,10.1,2228,48230,74554,15.3,10421,37094,62435,12.8,12119,30496,37172,5.4,5.2,25.6
2012,Illinois,1.6,207932,5037329,202332,26914,9.8,14253,25193,9.1,14126,474435,682367,13.5,86068,396697,599029,11.9,83338,217700,276756,4.1,4,23.8
2012,Indiana,3.3,103356,2470343,82451,11593,8.9,6372,10838,8.3,6269,243714,347070,14,41382,182470,264921,10.7,82149,97354,131243,4.2,3.3,21.4
2012,Iowa,2.3,43472,1272154,44966,6074,8.4,3136,5396,7.4,3116,115243,158715,12.5,19102,85198,130164,10.2,28551,55616,73020,3.4,3.5,20.4
2012,Kansas,2.6,51863,1109227,40062,5905,8.9,3317,5610,8.4,3264,99657,151520,13.7,20085,83341,123403,11.1,28117,51741,66938,4.7,3.6,22.2
2012,Kentucky,2.7,65803,1465476,51842,7250,8.9,4127,6818,8.4,4089,141722,207525,14.2,23720,116100,167942,11.5,39583,60938,82047,4.5,3.5,23
2012,Louisiana,1.9,69570,1613352,58654,8626,9.1,4753,7772,8.2,4707,160707,230277,14.3,31822,140608,199262,12.4,31015,73250,95673,4.3,3.6,24.8
2012,Maine,2.2,19953,474236,17783,3320,9.6,1830,3196,9.3,1818,43431,63384,13.4,9451,35423,53206,11.2,10178,27876,34656,4.2,3.7,22.4
2012,Maryland,2.5,95644,2120412,80763,11479,9.6,5899,10190,8.5,5840,208525,304169,14.3,33511,169935,250698,11.8,53471,94702,120696,4.5,3.8,23.6
2012,Massachusetts,2.9,102465,2951346,94252,14300,9.4,7265,12519,8.2,7176,277046,379511,12.9,45369,202314,296566,10,82945,121449,153355,3.5,3.2,20
2012,Michigan,2.9,146760,3414408,159532,17908,9.3,9477,16422,8.5,9349,362597,509357,14.9,81485,251722,411254,12,98103,149907,193894,4.3,4.7,24
2012,Minnesota,2.9,80423,2428855,79510,11563,9.1,5865,10649,8.4,5791,240937,321360,13.2,41428,170986,250496,10.3,70864,99812,127577,3.3,3.3,20.6
2012,Mississippi,1.1,32522,883500,28417,4482,8.3,2940,4547,8.4,2924,77985,110507,12.5,15878,72674,101091,11.4,9416,40654,54240,3.7,3.2,22.8
2012,Missouri,1.9,98084,2298178,80337,12941,9.8,8147,12620,9.6,8060,205841,303925,13.2,40556,178274,258611,11.3,45314,99998,131820,4.3,3.5,22.6
2012,Montana,2.6,16537,334743,12874,3323,10.8,1661,2844,9.3,1645,32011,48548,14.5,6937,26936,39810,11.9,8738,26311,31009,4.9,3.8,23.8
2012,Nebraska,3.1,33148,767653,22368,4059,8.7,2088,3593,7.7,2057,69589,102737,13.4,11544,57053,79421,10.3,23316,37168,47067,4.3,2.9,20.6
2012,Nevada,3.2,59107,1005799,47613,6486,12.6,3817,5950,11.6,3767,99468,158575,15.8,26410,78910,126523,12.6,32052,40292,51834,5.9,4.7,25.2
2012,New Hampshire,-0.7,20506,543887,28729,3113,9.4,1749,2841,8.6,1718,44729,65235,12,10978,40321,69050,12.7,-3815,26950,33332,3.8,5.3,24
2012,New Jersey,1.8,134059,3369316,135009,21240,10.6,12153,19176,9.5,12074,337235,471294,14,63242,276729,411738,12.2,59556,168215,202368,4,4,24.4
2012,New Mexico,0.5,27808,592770,25076,3821,9.6,2262,3636,9.2,2202,53157,80965,13.7,11098,53422,78498,13.2,2467,31183,39776,4.7,4.2,26.4
2012,New York,2.5,311589,7441512,270642,51047,11,28796,43871,9.5,28604,702744,1014333,13.6,148697,551821,822463,11.1,191870,391663,465996,4.2,3.6,22.2
2012,North Carolina,2.8,142018,3326358,124298,19306,10,10616,17574,9.1,10534,334750,476768,14.3,63645,259826,384124,11.5,92644,146425,195059,4.3,3.7,23
2012,North Dakota,7.8,18974,311942,10886,2386,11.8,954,1513,7.5,944,37567,56541,18.1,6546,21117,32003,10.3,24538,16787,20683,6.1,3.5,20.6
2012,Ohio,2.9,171479,4447644,163276,19471,8.5,10608,18429,8.1,10485,450651,622130,14,78617,331871,495147,11.1,126983,167489,229141,3.9,3.7,22.2
2012,Oklahoma,3,63397,1266162,48527,7971,9.7,4284,6868,8.4,4246,126596,189993,15,25046,102904,151431,12,38562,64261,82595,5,3.8,24
2012,Oregon,2.4,62149,1348910,52785,10035,10.5,5326,9293,9.7,5284,130165,192314,14.3,26531,107420,160205,11.9,32109,76776,95825,4.6,3.9,23.8
2012,Pennsylvania,2.3,201721,5059873,169839,22803,8.4,12433,21119,7.8,12306,468142,669863,13.2,79417,380333,550172,10.9,119691,206269,271751,4,3.4,21.8
2012,Rhode Island,0.9,16426,405522,13950,2363,9.5,1311,2239,9,1299,34319,50745,12.5,6761,32952,46902,11.6,3843,21068,24912,4.1,3.4,23.2
2012,South Carolina,2.1,64257,1515443,54632,8429,9.2,4869,7938,8.7,4815,146351,210608,13.9,26541,124209,178841,11.8,31767,68781,91685,4.2,3.6,23.6
2012,South Dakota,3.9,15643,324280,10300,2164,9.4,1134,1845,8.1,1125,29668,45311,14,5390,22410,32710,10.1,12601,18994,23119,4.8,3.2,20.2
2012,Tennessee,2.7,96938,2307993,85157,11049,9.2,6532,10552,8.8,6484,220708,317646,13.8,39797,171442,256599,11.1,61047,86957,120249,4.2,3.7,22.2
2012,Texas,4.1,493447,9032122,370478,53845,11.2,27137,43515,9.1,26777,981692,1475139,16.3,179303,733441,1103919,12.2,371220,357026,485545,5.5,4.1,24.4
2012,Utah,4.1,58194,1037334,43588,7496,12.6,3847,6240,10.5,3796,110803,168997,16.3,26546,82602,126190,12.2,42807,49094,60359,5.6,4.2,24.4
2012,Vermont,1.5,9592,263455,9546,1748,9.4,962,1609,8.6,952,27728,37320,14.2,5210,23994,33540,12.7,3780,15939,18787,3.6,3.6,25.4
2012,Virginia,2.2,133653,3009713,122593,16844,9.7,9071,15559,9,8951,321847,455500,15.1,48808,265692,388285,12.9,67215,131180,174438,4.4,4.1,25.8
2012,Washington,1.9,102272,2295186,88545,16452,10.7,9210,15606,10.2,9124,223968,326240,14.2,44907,193744,282289,12.3,43951,122980,153935,4.5,3.9,24.6
2012,West Virginia,2.6,22702,564982,20438,2760,7.8,1702,2774,7.9,1674,55182,77884,13.8,9193,42668,63106,11.2,14778,26246,35296,4,3.6,22.4
2012,Wisconsin,1.7,77435,2349754,72158,10408,8.4,5935,10087,8.1,5867,200888,278323,11.8,35075,165453,237611,10.1,40712,95700,124623,3.3,3.1,20.2
2012,Wyoming,3.3,11269,203410,10840,1923,10.7,1043,1687,9.4,1016,23256,34525,17,4929,17040,27880,13.7,6645,15471,18185,5.5,5.3,27.4
2013,Alabama,1.6,58278,1578455,57259,7072,7.9,4824,7214,8,4806,140731,199009,12.6,32696,115944,173203,11,25806,66905,90227,3.7,3.6,22
2013,Alaska,3,9449,259981,7658,1691,9.9,837,1553,9,836,25299,34748,13.4,4401,19467,27125,10.4,7623,13645,17283,3.6,2.9,20.8
2013,Arizona,2.2,96354,2120586,81510,12161,10.6,6963,10954,9.5,6918,203003,299357,14.1,47037,170811,252321,11.9,47036,86916,115965,4.5,3.8,23.8
2013,Arkansas,0.9,36152,969813,36143,4916,8.3,3324,4852,8.2,3278,80011,116163,12,18667,71677,107820,11.1,8343,45012,59083,3.7,3.7,22.2
2013,California,4,658867,12944028,512769,81236,10.7,46788,73969,9.7,46510,1338260,1997127,15.4,295224,957910,1470679,11.4,526448,608395,766124,5.1,4,22.8
2013,Colorado,4.8,96507,2040954,83035,14812,11.2,7866,12914,9.8,7841,237116,333623,16.3,47206,150761,233796,11.5,99827,107578,133041,4.7,4.1,23
2013,Connecticut,1.4,49151,1486501,45339,6565,8.3,3955,6569,8.3,3928,117101,166252,11.2,25969,100653,145992,9.8,20260,63598,79762,3.3,3.1,19.6
2013,Delaware,6.3,23824,373356,11814,2008,9.4,1095,1815,8.5,1088,37429,61253,16.4,5799,25738,37552,10.1,23701,16899,21471,6.4,3.2,20.2
2013,District of Columbia,1.8,19815,496221,17192,2017,10,853,1572,7.8,849,40442,60257,12.1,8653,33972,51164,10.3,9093,16060,20517,4,3.5,20.6
2013,Florida,2.7,360452,6820517,302470,52751,12,29569,45746,10.4,29482,666914,1027366,15.1,168779,546530,849000,12.4,178366,355174,444381,5.3,4.4,24.8
2013,Geogia,2.3,137800,3383796,139291,19387,10.1,11277,17793,9.3,11246,328766,466566,13.8,75615,250018,389309,11.5,77257,147556,193563,4.1,4.1,23
2013,Hawaii,1.9,17647,495066,17670,2318,8.1,1357,2220,7.7,1350,40250,57897,11.7,9733,30912,48582,9.8,9315,22478,28843,3.6,3.6,19.6
2013,Idaho,4.4,23448,503402,17858,3784,10.2,2255,3564,9.6,2251,50193,73641,14.6,12170,33485,51343,10.2,22298,30798,37488,4.7,3.5,20.4
2013,Illinois,2.2,212443,5120985,183664,25275,9.2,14763,24720,9,14651,454510,666953,13,100278,367716,551380,10.8,115573,218024,277239,4.1,3.6,21.6
2013,Indiana,2.1,86234,2518862,75392,9924,7.6,6543,10353,7.9,6514,221091,307325,12.2,45883,178623,254015,10.1,53310,96954,130644,3.4,3,20.2
2013,Iowa,1.3,41032,1291407,36421,5218,7.2,3270,5272,7.2,3249,95416,136448,10.6,20245,84182,120603,9.3,15845,55291,72903,3.2,2.8,18.6
2013,Kansas,1.9,41632,1129544,36007,5170,7.8,3434,5271,7.9,3416,97183,138815,12.3,22133,81905,117912,10.4,20903,51585,66766,3.7,3.2,20.8
2013,Kentucky,1.2,61543,1487223,57996,7015,8.6,4216,6420,7.8,4200,128716,190259,12.8,29184,114831,172827,11.6,17432,61239,82512,4.1,3.9,23.2
2013,Louisiana,2.7,65220,1644516,59166,7617,8,4889,7455,7.8,4869,161414,226634,13.8,37746,123526,182692,11.1,43942,73489,95911,4,3.6,22.2
2013,Maine,0.3,17235,477017,18858,2868,8.3,1738,2971,8.6,1725,37079,54314,11.4,11172,34067,52925,11.1,1389,27767,34520,3.6,4,22.2
2013,Maryland,2,98914,2162804,75954,11029,9.1,6029,10147,8.4,5998,185959,284873,13.2,43516,166825,242779,11.2,42094,95277,121666,4.6,3.5,22.4
2013,Massachusetts,2.4,106509,3023432,87877,13114,8.5,7287,12214,8,7211,247306,353815,11.7,48670,193874,281751,9.3,72064,122283,154320,3.5,2.9,18.6
2013,Michigan,2.1,127864,3493413,107215,15710,8.1,9701,15922,8.2,9677,312297,440161,12.6,63954,258108,365323,10.5,74838,150130,193720,3.7,3.1,21
2013,Minnesota,1.6,80118,2480836,68055,10581,8.3,5928,10010,7.9,5922,211506,291624,11.8,43419,185951,254006,10.2,37618,100081,128130,3.2,2.7,20.4
2013,Mississippi,1,28103,889329,24281,4073,7.5,2891,4102,7.6,2871,70820,98923,11.1,17954,65879,90160,10.1,8763,40653,54222,3.2,2.7,20.2
2013,Missouri,2,80437,2336733,72775,13048,9.9,7562,11426,8.6,7507,202941,283378,12.1,41846,162917,235692,10.1,47686,101482,133391,3.4,3.1,20.2
2013,Montana,4,18202,344744,11532,3099,10,1727,2833,9.1,1720,30676,48878,14.2,7902,23653,35185,10.2,13693,26602,31322,5.3,3.3,20.4
2013,Nebraska,0.3,24617,778041,24764,3717,7.9,2264,3537,7.5,2254,62928,87545,11.3,13916,60696,85460,11,2085,37230,47252,3.2,3.2,22
2013,Nevada,2,55777,1029297,47147,6350,12.2,3719,5555,10.7,3674,97928,153705,14.9,29562,85170,132317,12.9,21388,40954,52566,5.4,4.6,25.8
2013,New Hampshire,0.5,18497,541506,17305,2749,8.3,1726,2728,8.2,1722,43450,61947,11.4,9901,41545,58850,10.9,3097,26892,33336,3.4,3.2,21.8
2013,New Jersey,1.9,141598,3427468,141136,20074,9.9,12329,19267,9.5,12273,336045,477643,13.9,80547,270856,411992,12,65651,169057,203522,4.1,4.1,24
2013,New Mexico,0.7,26180,594029,24174,3398,8.6,2347,3544,8.9,2325,54617,80797,13.6,14365,52310,76484,12.9,4313,31114,39680,4.4,4.1,25.8
2013,New York,2,325921,7601643,286312,48036,10.3,28584,45751,9.8,28412,671289,997210,13.1,163837,555205,841517,11.1,155693,395139,468881,4.3,3.8,22.2
2013,North Carolina,1.7,142089,3385642,118577,18047,9.2,10931,16736,8.6,10898,306400,448489,13.2,65858,272040,390617,11.5,57872,147227,196421,4.2,3.5,23
2013,North Dakota,4.5,16764,329645,12754,2186,10.4,1079,1626,7.8,1079,34924,51688,15.7,7822,24091,36845,11.2,14843,17201,21254,5.1,3.9,22.4
2013,Ohio,1.9,154382,4540054,144560,17370,7.6,10696,17332,7.6,10639,416186,570568,12.6,79921,341469,486029,10.7,84539,166750,228573,3.4,3.2,21.4
2013,Oklahoma,2.6,56946,1299486,48036,7345,8.9,4447,6585,8,4417,119792,176738,13.6,32804,95420,143456,11,33282,64986,83453,4.4,3.7,22
2013,Oregon,3.7,56099,1385753,44471,9433,9.8,5249,8215,8.5,5241,135835,191934,13.9,28033,96989,141460,10.2,50474,77773,96996,4,3.2,20.4
2013,Pennsylvania,0.6,180455,5126320,158583,21418,7.9,12678,20442,7.5,12634,409292,589747,11.5,97083,399199,557782,10.9,31965,206131,272479,3.5,3.1,21.8
2013,Rhode Island,1.6,12710,410711,12941,2066,8.3,1327,2172,8.7,1326,34229,46939,11.4,7621,27119,40060,9.8,6879,20940,24852,3.1,3.2,19.6
2013,South Carolina,2.6,60986,1543565,46329,7916,8.7,4911,7432,8.1,4864,139445,200431,13,27081,114917,161246,10.4,39185,69262,92043,4,3,20.8
2013,South Dakota,1.1,11552,331673,13119,1805,7.8,1129,1761,7.6,1129,28461,40013,12.1,7176,23381,36500,11,3513,19097,23223,3.5,4,22
2013,Tennessee,2.8,92984,2362705,74330,10349,8.6,6489,9741,8.1,6436,229622,322606,13.7,43979,182161,256491,10.9,66115,87354,120750,3.9,3.1,21.8
2013,Texas,3.4,465621,9351528,377462,51051,10.4,27572,42183,8.6,27421,987441,1453062,15.5,206469,751526,1128988,12.1,324074,364402,494516,5,4,24.2
2013,Utah,3.2,56552,1072434,48524,7153,11.7,3586,5891,9.7,3572,107102,163654,15.3,30590,81562,130086,12.1,33568,50323,61781,5.3,4.5,24.2
2013,Vermont,-3.1,8778,261224,18803,1384,7.4,923,1499,8,923,20239,29017,11.1,15905,18293,37096,14.2,-8079,15853,18684,3.4,7.2,22.2
2013,Virginia,1.9,136552,3059020,100286,16361,9.4,8936,14705,8.4,8909,276833,413385,13.5,55527,254624,354910,11.6,58475,132186,175936,4.5,3.3,23.2
2013,Washington,3.1,103357,2345646,91042,16097,10.4,9163,14374,9.3,9111,222030,325387,13.9,49550,161541,252583,10.8,72804,124773,155742,4.4,3.9,21.6
2013,West Virginia,-0.2,19542,570133,21140,2333,6.7,1785,2773,7.9,1776,45819,65361,11.5,11409,45457,66597,11.7,-1236,25813,34873,3.4,3.7,23
2013,Wisconsin,1.2,69260,2377451,64469,9345,7.5,5807,9497,7.7,5763,185455,254715,10.7,37824,160483,224952,9.5,29763,95392,124334,2.9,2.7,19
2013,Wyoming,1.8,9739,208589,8998,1690,9.3,1131,1715,9.5,1128,20804,30543,14.6,5881,17797,26795,12.8,3748,15429,18193,4.7,4.3,25.6